Time,Team,Operation,BuyVolume,SellVolume,EtfPosition,FuturePosition,EtfPrice,FuturePrice,TotalFees,AccountBalance,ProfitOrLoss,Status
1e-06,TraderOne,Tick,0,0,0,0,,,0,0,0,OK
0.243132,TraderOne,Tick,0,0,0,0,,,0,0,0,OK
0.522121,TraderOne,Tick,0,0,0,0,,,0,0,0,OK
0.738484,TraderOne,Tick,0,0,0,0,,,0,0,0,OK
1.02091,TraderOne,Tick,0,10,-10,10,147600,147100,-147,147,-1853,OK
1.22733,TraderOne,Tick,1,10,-9,9,147100,147100,-162,162,162,OK
1.477198,TraderOne,Tick,1,10,-9,9,147100,147100,-162,162,162,OK
1.721337,TraderOne,Tick,1,10,-9,9,147100,147100,-162,162,162,OK
2.012796,TraderOne,Tick,1,10,-9,9,147100,147100,-162,162,162,OK
2.207919,TraderOne,Tick,1,10,-9,9,147100,146900,-162,162,-1638,OK
2.549722,TraderOne,Tick,11,10,1,-1,146400,146900,-309,-1691,-1891,OK
2.782491,TraderOne,Tick,11,10,1,-1,146400,146900,-309,-1691,-1891,OK
3.032377,TraderOne,Tick,11,10,1,-1,146400,146900,-309,-1691,-1891,OK
3.282089,TraderOne,Tick,11,10,1,-1,146400,146900,-309,-1691,-1891,OK
3.535848,TraderOne,Tick,11,20,-9,9,147500,146900,-456,-1544,-3344,OK
3.748832,TraderOne,Tick,21,20,1,-1,146300,146900,-603,-2397,-2597,OK
3.992222,TraderOne,Tick,21,20,1,-1,146300,146900,-603,-2397,-2597,OK
4.257319,TraderOne,Tick,21,20,1,-1,146300,146900,-603,-2397,-2597,OK
4.469067,TraderOne,Tick,21,20,1,-1,146300,146900,-603,-2397,-2597,OK
4.736759,TraderOne,Tick,31,20,11,-11,146300,146900,-750,-2250,-4450,OK
4.982098,TraderOne,Tick,31,20,11,-11,146300,146900,-750,-2250,-4450,OK
5.215177,TraderOne,Tick,31,20,11,-11,146300,146800,-750,-2250,-4450,OK
5.485265,TraderOne,Tick,31,20,11,-11,146300,146800,-750,-2250,-4450,OK
5.756122,TraderOne,Tick,31,20,11,-11,146300,146800,-750,-2250,-4450,OK
5.971121,TraderOne,Tick,31,30,1,-1,147000,146800,-456,-2544,-2344,OK
6.236899,TraderOne,Tick,31,40,-9,9,147000,146800,-162,-2838,-4638,OK
6.534811,TraderOne,Tick,31,50,-19,19,147000,146800,132,-132,-3932,OK
6.70669,TraderOne,Tick,31,60,-29,29,147200,146700,426,2574,-3226,OK
6.992618,TraderOne,Tick,31,60,-29,29,147200,146900,426,2574,-3226,OK
7.268233,TraderOne,Tick,31,60,-29,29,147200,146900,426,2574,-3226,OK
7.500643,TraderOne,Tick,31,60,-29,29,147200,146900,426,2574,-3226,OK
7.710814,TraderOne,Tick,31,60,-29,29,147200,146900,426,2574,-3226,OK
7.984144,TraderOne,Tick,31,60,-29,29,147200,146900,426,2574,-3226,OK
8.207776,TraderOne,Tick,41,60,-19,19,147000,146900,279,-279,-2179,OK
8.514283,TraderOne,Tick,41,60,-19,19,147000,146900,279,-279,-2179,OK
8.787158,TraderOne,Tick,41,60,-19,19,147000,146900,279,-279,-2179,OK
9.032548,TraderOne,Tick,51,60,-9,9,146700,146900,132,-2132,-332,OK
9.220132,TraderOne,Tick,61,60,1,-1,146400,146900,425,575,375,OK
9.504139,TraderOne,Tick,71,60,11,-11,146400,146900,718,2282,82,OK
9.759854,TraderOne,Tick,81,60,21,-21,146400,146900,1011,3989,-211,OK
9.973215,TraderOne,Tick,81,60,21,-21,146400,146900,1011,3989,-211,OK
10.271853,TraderOne,Tick,91,60,31,-31,146400,146900,1304,5696,-504,OK
10.492372,TraderOne,Tick,101,60,41,-41,146400,146900,1597,9403,1203,OK
10.738057,TraderOne,Tick,111,60,51,-51,146200,147000,1890,14110,3910,OK
11.004444,TraderOne,Tick,111,70,41,-41,147300,147000,1743,9257,17457,OK
11.229145,TraderOne,Tick,111,70,41,-41,147300,147000,1743,9257,17457,OK
11.547373,TraderOne,Tick,111,70,41,-41,147300,147000,1743,9257,17457,OK
11.75863,TraderOne,Tick,111,80,31,-31,147400,147200,1596,6404,12604,OK
12.026933,TraderOne,Tick,111,80,31,-31,147400,147200,1596,6404,12604,OK
12.295517,TraderOne,Tick,111,80,31,-31,147400,147200,1596,6404,12604,OK
12.504809,TraderOne,Tick,111,80,31,-31,147400,147200,1596,6404,12604,OK
12.754731,TraderOne,Tick,111,80,31,-31,147400,147200,1596,6404,12604,OK
12.961311,TraderOne,Tick,111,80,31,-31,147400,147200,1596,6404,12604,OK
13.300198,TraderOne,Tick,111,80,31,-31,146600,147200,1596,6404,204,OK
13.476648,TraderOne,Tick,111,80,31,-31,146600,147200,1596,6404,204,OK
13.771598,TraderOne,Tick,111,80,31,-31,146600,147200,1596,6404,204,OK
14.043286,TraderOne,Tick,111,80,31,-31,146600,147200,1596,6404,204,OK
14.295174,TraderOne,Tick,111,80,31,-31,146600,147200,1596,6404,204,OK
14.482317,TraderOne,Tick,111,80,31,-31,146600,147200,1596,6404,204,OK
14.723865,TraderOne,Tick,111,80,31,-31,146600,147200,1596,6404,204,OK
14.95647,TraderOne,Tick,111,80,31,-31,146600,147200,1596,6404,204,OK
15.240845,TraderOne,Tick,111,80,31,-31,146600,147200,1596,6404,204,OK
15.475019,TraderOne,Tick,111,90,21,-21,146900,146800,1449,3551,5651,OK
15.781428,TraderOne,Tick,111,100,11,-11,146600,146800,1742,258,-1942,OK
16.006416,TraderOne,Tick,111,110,1,-1,146900,146900,1595,-2595,-2595,OK
16.234814,TraderOne,Tick,111,110,1,-1,146900,146900,1595,-2595,-2595,OK
16.471762,TraderOne,Tick,111,110,1,-1,146900,146900,1595,-2595,-2595,OK
16.708252,TraderOne,Tick,111,110,1,-1,146900,146900,1595,-2595,-2595,OK
17.036077,TraderOne,Tick,111,110,1,-1,146900,146900,1595,-2595,-2595,OK
17.220722,TraderOne,Tick,111,110,1,-1,146900,146900,1595,-2595,-2595,OK
17.501869,TraderOne,Tick,111,110,1,-1,146900,146900,1595,-2595,-2595,OK
17.734674,TraderOne,Tick,121,110,11,-11,146900,146900,1889,-1889,-1889,OK
17.997725,TraderOne,Tick,131,110,21,-21,146600,146900,2183,-1183,-5383,OK
18.26041,TraderOne,Tick,131,110,21,-21,146600,146900,2183,-1183,-5383,OK
18.539534,TraderOne,Tick,131,110,21,-21,146600,147100,2183,-1183,-5383,OK
18.766662,TraderOne,Tick,131,110,21,-21,146600,147100,2183,-1183,-5383,OK
19.002133,TraderOne,Tick,131,110,21,-21,146600,147100,2183,-1183,-5383,OK
19.261357,TraderOne,Tick,131,110,21,-21,146600,147100,2183,-1183,-5383,OK
19.45613,TraderOne,Tick,131,110,21,-21,146600,147200,2183,-1183,-5383,OK
19.777704,TraderOne,Tick,141,110,31,-31,146900,147200,2477,523,-5677,OK
20.031754,TraderOne,Tick,141,110,31,-31,146900,147200,2477,523,-5677,OK
20.275868,TraderOne,Tick,151,110,41,-41,146900,147200,2771,3229,-4971,OK
20.528998,TraderOne,Tick,161,110,51,-51,146900,147900,3065,7935,-2265,OK
20.74658,TraderOne,Tick,171,120,51,-51,147500,147900,3212,10788,588,OK
21.034059,TraderOne,Tick,171,126,45,-45,147600,147900,3389,8811,-189,OK
21.298404,TraderOne,Tick,171,126,45,-45,147600,147900,3389,8811,-189,OK
21.474303,TraderOne,Tick,171,126,45,-45,147600,147900,3389,8811,-189,OK
21.751414,TraderOne,Tick,171,126,45,-45,147600,147900,3389,8811,-189,OK
21.962281,TraderOne,Tick,171,126,45,-45,147600,148000,3389,8811,-189,OK
22.203811,TraderOne,Tick,171,126,45,-45,147600,148000,3389,8811,-189,OK
22.457006,TraderOne,Tick,171,126,45,-45,147600,148100,3389,8811,-189,OK
22.745009,TraderOne,Tick,181,126,55,-55,147700,148200,3684,11516,516,OK
22.98873,TraderOne,Tick,181,126,55,-55,147700,148000,3684,11516,516,OK
23.283386,TraderOne,Tick,181,126,55,-55,147700,148000,3684,11516,516,OK
23.515204,TraderOne,Tick,181,136,45,-45,147400,147700,3979,8221,-779,OK
23.717966,TraderOne,Tick,181,136,45,-45,147400,147700,3979,8221,-779,OK
24.020343,TraderOne,Tick,181,136,45,-45,147400,147700,3979,8221,-779,OK
24.26616,TraderOne,Tick,181,136,45,-45,147400,147700,3979,8221,-779,OK
24.516073,TraderOne,Tick,191,136,55,-55,147400,147700,4274,10926,-74,OK
24.778912,TraderOne,Tick,191,136,55,-55,147400,148100,4274,10926,-74,OK
25.018847,TraderOne,Tick,191,136,55,-55,147400,148100,4274,10926,-74,OK
25.232216,TraderOne,Tick,201,136,65,-65,147700,148200,4569,15631,2631,OK
25.534875,TraderOne,Tick,201,146,55,-55,147600,147900,4864,9336,-1664,OK
25.796791,TraderOne,Tick,201,153,48,-48,147600,147900,4761,5939,-3661,OK
26.025611,TraderOne,Tick,201,153,48,-48,147600,147900,4761,5939,-3661,OK
26.207594,TraderOne,Tick,201,153,48,-48,147600,147900,4761,5939,-3661,OK
26.470813,TraderOne,Tick,201,153,48,-48,147400,147900,4761,5939,-3661,OK
26.707175,TraderOne,Tick,201,153,48,-48,147400,147900,4761,5939,-3661,OK
27.029351,TraderOne,Tick,201,153,48,-48,147400,147900,4761,5939,-3661,OK
27.204375,TraderOne,Tick,211,153,58,-58,147400,147900,4613,10087,-1513,OK
27.463805,TraderOne,Tick,211,153,58,-58,147400,147900,4613,10087,-1513,OK
27.780269,TraderOne,Tick,211,153,58,-58,147400,147900,4613,10087,-1513,OK
28.028034,TraderOne,Tick,221,163,58,-58,147200,147800,4318,10382,-1218,OK
28.205352,TraderOne,Tick,221,163,58,-58,147200,147800,4318,10382,-1218,OK
28.463199,TraderOne,Tick,221,173,48,-48,147700,147800,4171,5529,729,OK
28.721472,TraderOne,Tick,221,173,48,-48,147700,147600,4171,5529,10329,OK
28.97511,TraderOne,Tick,221,173,48,-48,147700,147600,4171,5529,10329,OK
29.237735,TraderOne,Tick,221,173,48,-48,147700,147600,4171,5529,10329,OK
29.494766,TraderOne,Tick,221,173,48,-48,147700,147600,4171,5529,10329,OK
29.767365,TraderOne,Tick,221,173,48,-48,147700,147600,4171,5529,10329,OK
29.969377,TraderOne,Tick,221,183,38,-38,147700,147600,4024,1676,5476,OK
30.209627,TraderOne,Tick,221,183,38,-38,147700,147600,4024,1676,5476,OK
30.530865,TraderOne,Tick,221,183,38,-38,147700,147600,4024,1676,5476,OK
30.783798,TraderOne,Tick,221,183,38,-38,147700,147400,4024,1676,9276,OK
30.988328,TraderOne,Tick,231,183,48,-48,147000,147400,4318,4382,-5218,OK
31.288741,TraderOne,Tick,231,183,48,-48,147000,147400,4318,4382,-5218,OK
31.535543,TraderOne,Tick,241,183,58,-58,147000,147400,4612,8088,-3512,OK
31.70155,TraderOne,Tick,241,183,58,-58,147000,147400,4612,8088,-3512,OK
32.005038,TraderOne,Tick,251,183,68,-68,147000,147400,4465,13235,-365,OK
32.242146,TraderOne,Tick,251,183,68,-68,147000,147400,4465,13235,-365,OK
32.47998,TraderOne,Tick,251,193,58,-58,147100,147400,4759,6941,-4659,OK
32.792777,TraderOne,Tick,251,193,58,-58,147100,147600,4759,6941,-4659,OK
32.951187,TraderOne,Tick,251,203,48,-48,147000,147600,5053,1647,-7953,OK
33.247217,TraderOne,Tick,251,203,48,-48,147000,147600,5053,1647,-7953,OK
33.526928,TraderOne,Tick,251,203,48,-48,147000,147600,5053,1647,-7953,OK
33.798226,TraderOne,Tick,251,213,38,-38,146900,147600,5347,-2647,-10247,OK
34.013415,TraderOne,Tick,251,213,38,-38,146900,147600,5347,-2647,-10247,OK
34.209098,TraderOne,Tick,251,213,38,-38,146900,147200,5347,-2647,-10247,OK
34.506592,TraderOne,Tick,251,213,38,-38,146900,147200,5347,-2647,-10247,OK
34.704982,TraderOne,Tick,251,213,38,-38,146900,147200,5347,-2647,-10247,OK
35.041575,TraderOne,Tick,251,213,38,-38,146900,147200,5347,-2647,-10247,OK
35.208343,TraderOne,Tick,251,213,38,-38,146900,147300,5347,-2647,-10247,OK
35.513762,TraderOne,Tick,251,223,28,-28,147100,147000,5200,-7500,-4700,OK
35.75984,TraderOne,Tick,251,233,18,-18,147200,147000,5494,-7794,-4194,OK
35.953739,TraderOne,Tick,251,233,18,-18,147200,147000,5494,-7794,-4194,OK
36.285187,TraderOne,Tick,251,233,18,-18,147200,147000,5494,-7794,-4194,OK
36.511919,TraderOne,Tick,251,240,11,-11,147200,147000,5700,-8700,-6500,OK
36.71568,TraderOne,Tick,251,240,11,-11,147200,147000,5700,-8700,-6500,OK
37.038072,TraderOne,Tick,251,240,11,-11,147200,147000,5700,-8700,-6500,OK
37.294446,TraderOne,Tick,251,240,11,-11,147200,147000,5700,-8700,-6500,OK
37.517625,TraderOne,Tick,251,240,11,-11,147200,147300,5700,-8700,-9800,OK
37.71388,TraderOne,Tick,251,240,11,-11,147200,147300,5700,-8700,-9800,OK
38.027312,TraderOne,Tick,251,240,11,-11,147200,147300,5700,-8700,-9800,OK
38.228315,TraderOne,Tick,251,240,11,-11,147200,147300,5700,-8700,-9800,OK
38.547839,TraderOne,Tick,251,240,11,-11,147200,147300,5700,-8700,-9800,OK
38.784134,TraderOne,Tick,251,240,11,-11,147200,147300,5700,-8700,-9800,OK
39.004753,TraderOne,Tick,251,240,11,-11,147200,147300,5700,-8700,-9800,OK
39.293774,TraderOne,Tick,261,240,21,-21,147500,147300,5553,-7553,-3353,OK
39.546391,TraderOne,Tick,261,250,11,-11,147700,147300,5406,-9406,-7206,OK
39.762667,TraderOne,Tick,261,250,11,-11,147700,147300,5406,-9406,-7206,OK
39.980936,TraderOne,Tick,261,250,11,-11,147700,147300,5406,-9406,-7206,OK
40.287388,TraderOne,Tick,261,250,11,-11,147700,147300,5406,-9406,-7206,OK
40.478028,TraderOne,Tick,261,260,1,-1,147700,147300,5259,-9259,-9059,OK
40.758478,TraderOne,Tick,261,260,1,-1,147700,147300,5259,-9259,-9059,OK
40.975159,TraderOne,Tick,261,260,1,-1,147700,147300,5259,-9259,-9059,OK
41.201045,TraderOne,Tick,261,260,1,-1,147700,147300,5259,-9259,-9059,OK
41.468223,TraderOne,Tick,261,260,1,-1,147700,147300,5259,-9259,-9059,OK
41.771667,TraderOne,Tick,261,260,1,-1,147700,147300,5259,-9259,-9059,OK
41.998133,TraderOne,Tick,261,260,1,-1,147700,147300,5259,-9259,-9059,OK
42.229624,TraderOne,Tick,261,268,-7,7,147500,147200,5141,-8341,-9741,OK
42.463895,TraderOne,Tick,261,268,-7,7,147500,147200,5141,-8341,-9741,OK
42.767216,TraderOne,Tick,261,268,-7,7,147500,147200,5141,-8341,-9741,OK
42.999555,TraderOne,Tick,261,268,-7,7,147500,147200,5141,-8341,-9741,OK
43.268632,TraderOne,Tick,261,268,-7,7,147500,147200,5141,-8341,-9741,OK
43.46604,TraderOne,Tick,261,268,-7,7,147500,147200,5141,-8341,-9741,OK
43.705741,TraderOne,Tick,261,268,-7,7,147500,147400,5141,-8341,-9041,OK
43.958416,TraderOne,Tick,261,268,-7,7,147500,147400,5141,-8341,-9041,OK
44.21593,TraderOne,Tick,261,268,-7,7,147500,147400,5141,-8341,-9041,OK
44.531334,TraderOne,Tick,261,268,-7,7,147500,147400,5141,-8341,-9041,OK
44.740206,TraderOne,Tick,261,268,-7,7,147500,147400,5141,-8341,-9041,OK
44.987612,TraderOne,Tick,261,268,-7,7,147700,147400,5141,-8341,-9741,OK
45.231094,TraderOne,Tick,261,268,-7,7,147700,147400,5141,-8341,-9741,OK
45.547615,TraderOne,Tick,261,268,-7,7,147700,147500,5141,-8341,-9741,OK
45.790862,TraderOne,Tick,261,278,-17,17,147400,147500,5436,-8636,-6936,OK
46.025685,TraderOne,Tick,261,278,-17,17,147400,147500,5436,-8636,-6936,OK
46.274589,TraderOne,Tick,261,278,-17,17,147400,147500,5436,-8636,-6936,OK
46.547257,TraderOne,Tick,261,278,-17,17,147400,147500,5436,-8636,-6936,OK
46.728258,TraderOne,Tick,261,278,-17,17,147400,147500,5436,-8636,-6936,OK
46.96992,TraderOne,Tick,261,278,-17,17,147400,147500,5436,-8636,-6936,OK
47.230241,TraderOne,Tick,261,278,-17,17,147400,147500,5436,-8636,-6936,OK
47.519298,TraderOne,Tick,261,278,-17,17,147400,147500,5436,-8636,-6936,OK
47.752609,TraderOne,Tick,261,288,-27,27,147700,147500,5288,-7488,-12888,OK
48.002996,TraderOne,Tick,261,288,-27,27,147700,147500,5288,-7488,-12888,OK
48.249094,TraderOne,Tick,261,288,-27,27,147700,147500,5288,-7488,-12888,OK
48.496818,TraderOne,Tick,264,288,-24,24,147400,147500,5244,-8644,-6244,OK
48.755853,TraderOne,Tick,264,288,-24,24,147400,147500,5244,-8644,-6244,OK
49.014249,TraderOne,Tick,264,288,-24,24,147400,147500,5244,-8644,-6244,OK
49.243918,TraderOne,Tick,264,288,-24,24,147400,147500,5244,-8644,-6244,OK
49.479918,TraderOne,Tick,274,288,-14,14,147700,147500,5539,-11939,-14739,OK
49.724879,TraderOne,Tick,274,288,-14,14,147700,147500,5539,-11939,-14739,OK
49.984032,TraderOne,Tick,274,288,-14,14,147700,147500,5539,-11939,-14739,OK
50.268822,TraderOne,Tick,274,288,-14,14,147700,147500,5539,-11939,-14739,OK
50.529714,TraderOne,Tick,274,288,-14,14,147700,147500,5539,-11939,-14739,OK
50.768377,TraderOne,Tick,274,288,-14,14,147700,147500,5539,-11939,-14739,OK
51.026268,TraderOne,Tick,274,288,-14,14,147700,147500,5539,-11939,-14739,OK
51.201287,TraderOne,Tick,274,288,-14,14,147700,147500,5539,-11939,-14739,OK
51.497644,TraderOne,Tick,274,288,-14,14,147700,147500,5539,-11939,-14739,OK
51.736582,TraderOne,Tick,274,288,-14,14,147700,147500,5539,-11939,-14739,OK
51.975823,TraderOne,Tick,274,288,-14,14,147700,147300,5539,-11939,-14739,OK
52.256784,TraderOne,Tick,274,288,-14,14,147700,147300,5539,-11939,-14739,OK
52.483538,TraderOne,Tick,274,288,-14,14,147700,147300,5539,-11939,-14739,OK
52.784512,TraderOne,Tick,274,288,-14,14,147700,147300,5539,-11939,-14739,OK
52.969987,TraderOne,Tick,274,288,-14,14,147700,147300,5539,-11939,-14739,OK
53.28242,TraderOne,Tick,274,288,-14,14,147700,147300,5539,-11939,-14739,OK
53.539796,TraderOne,Tick,274,288,-14,14,147700,147300,5539,-11939,-14739,OK
53.784304,TraderOne,Tick,274,288,-14,14,147700,147300,5539,-11939,-14739,OK
54.016456,TraderOne,Tick,274,288,-14,14,147700,147300,5539,-11939,-14739,OK
54.222488,TraderOne,Tick,274,288,-14,14,147800,147300,5539,-11939,-14739,OK
54.456182,TraderOne,Tick,274,288,-14,14,147800,147200,5539,-11939,-14739,OK
54.770872,TraderOne,Tick,274,288,-14,14,147800,147200,5539,-11939,-14739,OK
55.009635,TraderOne,Tick,274,288,-14,14,147800,147200,5539,-11939,-14739,OK
55.215399,TraderOne,Tick,274,288,-14,14,147800,147300,5539,-11939,-14739,OK
55.478285,TraderOne,Tick,274,288,-14,14,147300,147000,5539,-11939,-14739,OK
55.745761,TraderOne,Tick,274,298,-24,24,147100,146900,5834,-10234,-15034,OK
56.031177,TraderOne,Tick,274,298,-24,24,147100,147100,5834,-10234,-10234,OK
56.224594,TraderOne,Tick,274,298,-24,24,147100,147100,5834,-10234,-10234,OK
56.522079,TraderOne,Tick,274,298,-24,24,147100,147100,5834,-10234,-10234,OK
56.74629,TraderOne,Tick,274,298,-24,24,147100,147100,5834,-10234,-10234,OK
56.987741,TraderOne,Tick,274,298,-24,24,147100,147100,5834,-10234,-10234,OK
57.289772,TraderOne,Tick,274,298,-24,24,147100,147100,5834,-10234,-10234,OK
57.502531,TraderOne,Tick,274,298,-24,24,147100,146800,5834,-10234,-15034,OK
57.704439,TraderOne,Tick,274,308,-34,34,147000,146700,6128,-6828,-13628,OK
57.953042,TraderOne,Tick,274,308,-34,34,147000,146600,6128,-6828,-13628,OK
58.211848,TraderOne,Tick,274,308,-34,34,147000,146600,6128,-6828,-13628,OK
58.549372,TraderOne,Tick,274,308,-34,34,147000,146700,6128,-6828,-13628,OK
58.717132,TraderOne,Tick,274,308,-34,34,147000,146700,6128,-6828,-13628,OK
58.966492,TraderOne,Tick,274,308,-34,34,147000,146700,6128,-6828,-13628,OK
59.241714,TraderOne,Tick,274,308,-34,34,147000,146700,6128,-6828,-13628,OK
59.546039,TraderOne,Tick,274,318,-44,44,147000,146500,6422,-3122,-11922,OK
59.761927,TraderOne,Tick,274,318,-44,44,147000,146500,6422,-3122,-11922,OK
59.9946,TraderOne,Tick,274,318,-44,44,147000,146500,6422,-3122,-11922,OK
60.231822,TraderOne,Tick,274,318,-44,44,147000,146700,6422,-3122,-11922,OK
60.511458,TraderOne,Tick,274,318,-44,44,147000,146700,6422,-3122,-11922,OK
60.736205,TraderOne,Tick,274,318,-44,44,147000,146600,6422,-3122,-11922,OK
60.976102,TraderOne,Tick,274,318,-44,44,147000,146500,6422,-3122,-11922,OK
61.263639,TraderOne,Tick,274,318,-44,44,147000,146500,6422,-3122,-11922,OK
61.549149,TraderOne,Tick,274,318,-44,44,147000,146500,6422,-3122,-11922,OK
61.714144,TraderOne,Tick,274,318,-44,44,147000,146500,6422,-3122,-11922,OK
61.965575,TraderOne,Tick,274,318,-44,44,147000,146500,6422,-3122,-11922,OK
62.246121,TraderOne,Tick,274,318,-44,44,147000,146500,6422,-3122,-11922,OK
62.506611,TraderOne,Tick,274,328,-54,54,146700,146300,6716,2584,-8216,OK
62.721107,TraderOne,Tick,284,328,-44,44,146800,146300,7010,-3710,-12510,OK
63.017718,TraderOne,Tick,294,328,-34,34,146800,146300,6863,-9563,-16363,OK
63.300038,TraderOne,Tick,294,328,-34,34,146800,146300,6863,-9563,-16363,OK
63.469812,TraderOne,Tick,294,328,-34,34,146800,146300,6863,-9563,-16363,OK
63.783111,TraderOne,Tick,294,328,-34,34,146800,146300,6863,-9563,-16363,OK
63.982148,TraderOne,Tick,294,328,-34,34,146800,146300,6863,-9563,-16363,OK
64.266739,TraderOne,Tick,304,328,-24,24,146700,146300,7157,-12857,-17657,OK
64.493318,TraderOne,Tick,304,328,-24,24,146700,146300,7157,-12857,-17657,OK
64.730726,TraderOne,Tick,304,328,-24,24,146700,146300,7157,-12857,-17657,OK
64.963765,TraderOne,Tick,304,328,-24,24,146700,146300,7157,-12857,-17657,OK
65.288422,TraderOne,Tick,304,328,-24,24,146700,146900,7157,-12857,-8057,OK
65.491308,TraderOne,Tick,304,328,-24,24,146700,146900,7157,-12857,-8057,OK
65.789844,TraderOne,Tick,304,328,-24,24,146700,146900,7157,-12857,-8057,OK
66.01901,TraderOne,Tick,314,328,-14,14,146600,146900,7010,-15710,-12910,OK
66.279532,TraderOne,Tick,314,328,-14,14,146600,146900,7010,-15710,-12910,OK
66.498631,TraderOne,Tick,314,338,-24,24,147300,146900,6863,-12563,-17363,OK
66.716581,TraderOne,Tick,314,338,-24,24,147300,146900,6863,-12563,-17363,OK
66.957553,TraderOne,Tick,324,338,-14,14,146500,146900,6716,-15416,-12616,OK
67.224734,TraderOne,Tick,324,338,-14,14,146500,146900,6716,-15416,-12616,OK
67.46531,TraderOne,Tick,324,338,-14,14,146500,146900,6716,-15416,-12616,OK
67.769745,TraderOne,Tick,334,338,-4,4,146900,146900,7010,-17710,-17710,OK
67.997062,TraderOne,Tick,334,338,-4,4,146900,146900,7010,-17710,-17710,OK
68.214442,TraderOne,Tick,334,348,-14,14,146900,146900,6863,-17563,-17563,OK
68.467112,TraderOne,Tick,344,358,-14,14,146500,146900,7010,-16710,-13910,OK
68.751841,TraderOne,Tick,344,358,-14,14,146500,147200,7010,-16710,-13910,OK
69.039214,TraderOne,Tick,344,358,-14,14,146500,147200,7010,-16710,-13910,OK
69.276621,TraderOne,Tick,344,368,-24,24,147500,147200,6863,-14563,-19363,OK
69.480435,TraderOne,Tick,344,368,-24,24,147500,147200,6863,-14563,-19363,OK
69.73816,TraderOne,Tick,344,368,-24,24,147500,147300,6863,-14563,-19363,OK
70.021598,TraderOne,Tick,344,368,-24,24,147500,147300,6863,-14563,-19363,OK
70.248024,TraderOne,Tick,344,368,-24,24,147500,147300,6863,-14563,-19363,OK
70.475727,TraderOne,Tick,344,368,-24,24,147500,147300,6863,-14563,-19363,OK
70.762047,TraderOne,Tick,354,368,-14,14,146500,147300,6716,-17416,-14616,OK
71.020622,TraderOne,Tick,354,368,-14,14,146500,147300,6716,-17416,-14616,OK
71.20954,TraderOne,Tick,354,368,-14,14,146500,147300,6716,-17416,-14616,OK
71.526829,TraderOne,Tick,354,368,-14,14,146500,147300,6716,-17416,-14616,OK
71.752572,TraderOne,Tick,354,368,-14,14,146500,147300,6716,-17416,-14616,OK
71.960981,TraderOne,Tick,354,368,-14,14,146500,147300,6716,-17416,-14616,OK
72.246464,TraderOne,Tick,354,368,-14,14,146500,147300,6716,-17416,-14616,OK
72.521469,TraderOne,Tick,354,368,-14,14,147500,147300,6716,-17416,-20216,OK
72.758827,TraderOne,Tick,354,368,-14,14,147500,147300,6716,-17416,-20216,OK
72.958496,TraderOne,Tick,354,368,-14,14,147600,147300,6716,-17416,-20216,OK
73.293414,TraderOne,Tick,354,368,-14,14,147600,147300,6716,-17416,-20216,OK
73.543358,TraderOne,Tick,354,368,-14,14,147600,147200,6716,-17416,-20216,OK
73.784835,TraderOne,Tick,354,368,-14,14,147600,147200,6716,-17416,-20216,OK
73.95252,TraderOne,Tick,354,368,-14,14,147600,147200,6716,-17416,-20216,OK
74.245007,TraderOne,Tick,354,368,-14,14,147600,147200,6716,-17416,-20216,OK
74.472227,TraderOne,Tick,354,368,-14,14,147600,147200,6716,-17416,-20216,OK
74.712833,TraderOne,Tick,354,368,-14,14,147600,147200,6716,-17416,-20216,OK
74.951632,TraderOne,Tick,354,368,-14,14,147600,147200,6716,-17416,-20216,OK
75.251133,TraderOne,Tick,354,368,-14,14,147600,147400,6716,-17416,-20216,OK
75.456017,TraderOne,Tick,354,368,-14,14,147600,147400,6716,-17416,-20216,OK
75.715877,TraderOne,Tick,354,368,-14,14,147600,147400,6716,-17416,-20216,OK
75.99957,TraderOne,Tick,354,368,-14,14,147600,147400,6716,-17416,-20216,OK
76.242355,TraderOne,Tick,354,368,-14,14,147600,147400,6716,-17416,-20216,OK
76.499637,TraderOne,Tick,354,368,-14,14,147600,147500,6716,-17416,-18816,OK
76.794486,TraderOne,Tick,364,368,-4,4,147600,147600,7011,-18711,-18711,OK
77.01247,TraderOne,Tick,364,368,-4,4,147600,147600,7011,-18711,-18711,OK
77.242227,TraderOne,Tick,364,378,-14,14,147500,147600,7306,-18006,-16606,OK
77.53437,TraderOne,Tick,364,378,-14,14,147500,147600,7306,-18006,-16606,OK
77.749023,TraderOne,Tick,374,378,-4,4,147400,147600,7159,-19859,-19059,OK
77.988444,TraderOne,Tick,374,378,-4,4,147400,147600,7159,-19859,-19059,OK
78.272669,TraderOne,Tick,374,378,-4,4,147400,147600,7159,-19859,-19059,OK
78.475943,TraderOne,Tick,376,378,-2,2,147400,147600,7218,-20118,-19718,OK
78.708457,TraderOne,Tick,376,378,-2,2,147400,147600,7218,-20118,-19718,OK
78.975773,TraderOne,Tick,376,378,-2,2,147400,147600,7218,-20118,-19718,OK
79.24492,TraderOne,Tick,386,378,8,-8,147600,147600,7513,-20413,-20413,OK
79.465205,TraderOne,Tick,386,378,8,-8,147600,147600,7513,-20413,-20413,OK
79.752378,TraderOne,Tick,396,378,18,-18,147600,148500,7808,-18708,-22308,OK
79.960249,TraderOne,Tick,406,378,28,-28,147900,148400,8103,-12603,-18203,OK
80.284791,TraderOne,Tick,416,378,38,-38,147900,148400,8399,-9899,-17499,OK
80.500203,TraderOne,Tick,426,378,48,-48,147900,148400,8695,-6195,-15795,OK
80.770426,TraderOne,Tick,426,378,48,-48,147900,148400,8695,-6195,-15795,OK
81.036691,TraderOne,Tick,436,378,58,-58,147900,148400,8991,-2491,-14091,OK
81.270974,TraderOne,Tick,436,378,58,-58,147900,148200,8991,-2491,-14091,OK
81.518592,TraderOne,Tick,436,388,48,-48,148000,148400,8843,-11343,-20943,OK
81.715835,TraderOne,Tick,446,388,58,-58,148100,148400,9139,-7639,-19239,OK
82.040209,TraderOne,Tick,456,388,68,-68,148000,148400,8991,-2491,-16091,OK
82.275849,TraderOne,Tick,456,388,68,-68,148000,148400,8991,-2491,-16091,OK
82.511753,TraderOne,Tick,456,398,58,-58,148200,148800,8843,-8343,-19943,OK
82.703629,TraderOne,Tick,456,398,58,-58,148200,148800,8843,-8343,-19943,OK
82.969224,TraderOne,Tick,456,398,58,-58,148200,148800,8843,-8343,-19943,OK
83.238617,TraderOne,Tick,456,398,58,-58,148300,148800,8843,-8343,-19943,OK
83.526246,TraderOne,Tick,456,398,58,-58,148300,148800,8843,-8343,-19943,OK
83.728706,TraderOne,Tick,456,398,58,-58,148300,148800,8843,-8343,-19943,OK
84.030467,TraderOne,Tick,456,398,58,-58,148400,149000,8843,-8343,-19943,OK
84.25859,TraderOne,Tick,456,398,58,-58,148400,149000,8843,-8343,-19943,OK
84.520815,TraderOne,Tick,456,398,58,-58,148400,149000,8843,-8343,-19943,OK
84.719537,TraderOne,Tick,456,398,58,-58,148400,149200,8843,-8343,-19943,OK
84.989875,TraderOne,Tick,466,398,68,-68,148600,149200,9140,-2640,-16240,OK
85.201105,TraderOne,Tick,466,408,58,-58,148600,149200,9437,-8937,-20537,OK
85.548913,TraderOne,Tick,466,418,48,-48,148800,149200,9288,-13788,-23388,OK
85.729685,TraderOne,Tick,466,418,48,-48,148800,149200,9288,-13788,-23388,OK
85.951283,TraderOne,Tick,476,418,58,-58,148800,149600,9586,-9086,-20686,OK
86.240997,TraderOne,Tick,486,428,58,-58,149000,149600,9735,-11235,-22835,OK
86.531786,TraderOne,Tick,486,428,58,-58,149000,149600,9735,-11235,-22835,OK
86.795165,TraderOne,Tick,486,438,48,-48,149600,149600,9586,-17086,-17086,OK
86.998874,TraderOne,Tick,486,438,48,-48,149600,149600,9586,-17086,-17086,OK
87.224731,TraderOne,Tick,486,438,48,-48,149600,149600,9586,-17086,-17086,OK
87.476962,TraderOne,Tick,486,438,48,-48,149600,149700,9586,-17086,-21886,OK
87.713842,TraderOne,Tick,486,438,48,-48,149600,149700,9586,-17086,-21886,OK
87.981575,TraderOne,Tick,486,438,48,-48,149600,149500,9586,-17086,-12286,OK
88.230974,TraderOne,Tick,486,438,48,-48,149600,149500,9586,-17086,-12286,OK
88.504762,TraderOne,Tick,486,438,48,-48,149600,149200,9586,-17086,-7486,OK
88.785446,TraderOne,Tick,486,438,48,-48,149600,149200,9586,-17086,-7486,OK
88.966437,TraderOne,Tick,486,438,48,-48,149600,149100,9586,-17086,-7486,OK
89.275314,TraderOne,Tick,486,438,48,-48,149600,149100,9586,-17086,-7486,OK
89.545526,TraderOne,Tick,486,438,48,-48,149600,148900,9586,-17086,-7486,OK
89.760462,TraderOne,Tick,486,438,48,-48,149600,148900,9586,-17086,-7486,OK
89.971784,TraderOne,Tick,486,438,48,-48,149600,148900,9586,-17086,-7486,OK
90.214012,TraderOne,Tick,486,438,48,-48,149600,148900,9586,-17086,-7486,OK
90.484942,TraderOne,Tick,486,438,48,-48,149600,149100,9586,-17086,-7486,OK
90.795036,TraderOne,Tick,486,438,48,-48,149600,149100,9586,-17086,-7486,OK
90.979763,TraderOne,Tick,486,448,38,-38,148700,149100,9437,-20937,-28537,OK
91.211154,TraderOne,Tick,486,458,28,-28,149400,149100,9736,-18236,-12636,OK
91.483378,TraderOne,Tick,486,463,23,-23,149400,148900,9885,-16385,-11785,OK
91.788207,TraderOne,Tick,486,468,18,-18,149600,148900,9811,-17811,-14211,OK
91.97553,TraderOne,Tick,486,472,14,-14,149500,148900,9931,-16331,-13531,OK
92.227892,TraderOne,Tick,496,472,24,-24,148500,148900,9782,-15182,-19982,OK
92.472795,TraderOne,Tick,496,472,24,-24,148500,148900,9782,-15182,-19982,OK
92.706328,TraderOne,Tick,496,472,24,-24,148500,148900,9782,-15182,-19982,OK
92.977575,TraderOne,Tick,496,472,24,-24,148500,148900,9782,-15182,-19982,OK
93.208239,TraderOne,Tick,496,472,24,-24,148500,149200,9782,-15182,-19982,OK
93.488081,TraderOne,Tick,496,472,24,-24,148500,149200,9782,-15182,-19982,OK
93.703789,TraderOne,Tick,496,472,24,-24,148500,149200,9782,-15182,-19982,OK
93.951211,TraderOne,Tick,496,472,24,-24,148500,149200,9782,-15182,-19982,OK
94.269073,TraderOne,Tick,496,472,24,-24,148500,149200,9782,-15182,-19982,OK
94.545706,TraderOne,Tick,496,472,24,-24,148500,149200,9782,-15182,-19982,OK
94.775824,TraderOne,Tick,496,472,24,-24,148500,149200,9782,-15182,-19982,OK
95.030118,TraderOne,Tick,496,472,24,-24,148500,149200,9782,-15182,-19982,OK
95.234877,TraderOne,Tick,496,472,24,-24,148500,149200,9782,-15182,-19982,OK
95.543039,TraderOne,Tick,496,472,24,-24,148500,149200,9782,-15182,-19982,OK
95.768999,TraderOne,Tick,496,472,24,-24,148500,149200,9782,-15182,-19982,OK
95.998347,TraderOne,Tick,496,472,24,-24,148500,149200,9782,-15182,-19982,OK
96.296708,TraderOne,Tick,496,472,24,-24,148500,149200,9782,-15182,-19982,OK
96.463136,TraderOne,Tick,496,472,24,-24,148500,149200,9782,-15182,-19982,OK
96.756008,TraderOne,Tick,496,472,24,-24,148500,149200,9782,-15182,-19982,OK
96.954374,TraderOne,Tick,496,472,24,-24,148500,149200,9782,-15182,-19982,OK
97.20424,TraderOne,Tick,496,472,24,-24,148500,149200,9782,-15182,-19982,OK
97.462873,TraderOne,Tick,506,482,24,-24,149800,149600,9483,-14883,-10083,OK
97.730971,TraderOne,Tick,506,482,24,-24,149800,149600,9483,-14883,-10083,OK
97.961211,TraderOne,Tick,506,482,24,-24,149800,149900,9483,-14883,-17283,OK
98.20219,TraderOne,Tick,506,482,24,-24,149800,149800,9483,-14883,-14883,OK
98.530684,TraderOne,Tick,516,492,24,-24,149800,149800,9183,-14583,-14583,OK
98.758647,TraderOne,Tick,516,492,24,-24,149800,149800,9183,-14583,-14583,OK
99.033818,TraderOne,Tick,516,492,24,-24,149800,149900,9183,-14583,-16983,OK
99.268011,TraderOne,Tick,516,492,24,-24,149800,150100,9183,-14583,-21783,OK
99.539277,TraderOne,Tick,526,492,34,-34,149800,150000,9483,-12883,-19683,OK
99.750588,TraderOne,Tick,526,492,34,-34,149800,150000,9483,-12883,-19683,OK
99.998442,TraderOne,Tick,526,492,34,-34,149800,150000,9483,-12883,-19683,OK
100.274417,TraderOne,Tick,526,502,24,-24,149900,149900,9333,-15733,-15733,OK
100.45575,TraderOne,Tick,526,502,24,-24,149900,149900,9333,-15733,-15733,OK
100.732803,TraderOne,Tick,526,502,24,-24,149900,149900,9333,-15733,-15733,OK
100.983708,TraderOne,Tick,526,502,24,-24,149900,149900,9333,-15733,-15733,OK
101.294593,TraderOne,Tick,536,502,34,-34,149400,149900,9183,-13583,-23783,OK
101.527373,TraderOne,Tick,536,502,34,-34,149400,150100,9183,-13583,-23783,OK
101.764262,TraderOne,Tick,536,502,34,-34,149400,150100,9183,-13583,-23783,OK
102.034914,TraderOne,Tick,536,502,34,-34,149400,150100,9183,-13583,-23783,OK
102.264341,TraderOne,Tick,536,502,34,-34,149400,150100,9183,-13583,-23783,OK
102.474894,TraderOne,Tick,536,502,34,-34,149400,150100,9183,-13583,-23783,OK
102.760779,TraderOne,Tick,546,502,44,-44,149900,150300,9483,-10883,-24083,OK
102.962122,TraderOne,Tick,546,502,44,-44,149900,150300,9483,-10883,-24083,OK
103.242757,TraderOne,Tick,546,502,44,-44,149900,150300,9483,-10883,-24083,OK
103.500231,TraderOne,Tick,550,502,48,-48,149900,150300,9423,-8823,-23223,OK
103.763224,TraderOne,Tick,554,502,52,-52,149900,150300,9543,-7343,-22943,OK
104.049918,TraderOne,Tick,554,502,52,-52,149900,150400,9543,-7343,-22943,OK
104.292743,TraderOne,Tick,554,502,52,-52,149900,150200,9543,-7343,-22943,OK
104.477605,TraderOne,Tick,554,512,42,-42,149700,150200,9842,-12642,-25242,OK
104.775196,TraderOne,Tick,554,512,42,-42,149700,150200,9842,-12642,-25242,OK
105.001911,TraderOne,Tick,554,512,42,-42,149700,150200,9842,-12642,-25242,OK
105.221989,TraderOne,Tick,554,512,42,-42,149700,150200,9842,-12642,-25242,OK
105.526796,TraderOne,Tick,554,512,42,-42,149700,150200,9842,-12642,-25242,OK
105.768725,TraderOne,Tick,554,512,42,-42,149700,150200,9842,-12642,-25242,OK
105.976999,TraderOne,Tick,554,512,42,-42,149700,150300,9842,-12642,-25242,OK
106.230772,TraderOne,Tick,554,522,32,-32,150000,150500,9692,-18492,-28092,OK
106.513833,TraderOne,Tick,564,522,42,-42,150200,150500,9542,-15342,-27942,OK
106.712276,TraderOne,Tick,564,522,42,-42,150200,150400,9542,-15342,-23742,OK
106.973796,TraderOne,Tick,564,522,42,-42,150200,150300,9542,-15342,-19542,OK
107.295431,TraderOne,Tick,564,522,42,-42,150200,150300,9542,-15342,-19542,OK
107.491925,TraderOne,Tick,564,522,42,-42,150200,150400,9542,-15342,-23742,OK
107.756874,TraderOne,Tick,564,522,42,-42,150200,150400,9542,-15342,-23742,OK
107.991718,TraderOne,Tick,564,522,42,-42,150200,150400,9542,-15342,-23742,OK
108.271247,TraderOne,Tick,564,522,42,-42,150200,150300,9542,-15342,-19542,OK
108.49483,TraderOne,Tick,564,522,42,-42,150200,150100,9542,-15342,-11142,OK
108.76937,TraderOne,Tick,564,532,32,-32,149600,150100,9842,-19642,-29242,OK
108.956108,TraderOne,Tick,564,532,32,-32,149600,150100,9842,-19642,-29242,OK
109.206792,TraderOne,Tick,564,532,32,-32,149600,150100,9842,-19642,-29242,OK
109.511233,TraderOne,Tick,564,542,22,-22,149900,150100,9692,-22492,-26892,OK
109.785918,TraderOne,Tick,564,552,12,-12,150100,150100,9992,-23792,-23792,OK
110.016132,TraderOne,Tick,564,562,2,-2,150100,150100,10292,-24092,-24092,OK
110.271141,TraderOne,Tick,574,562,12,-12,150200,150500,10592,-22392,-25992,OK
110.531276,TraderOne,Tick,584,562,22,-22,150200,150500,10892,-20692,-27292,OK
110.748881,TraderOne,Tick,594,562,32,-32,150200,150700,11192,-17992,-27592,OK
111.030173,TraderOne,Tick,604,562,42,-42,150200,150600,11492,-14292,-26892,OK
111.244657,TraderOne,Tick,614,562,52,-52,150200,150600,11792,-10592,-26192,OK
111.546392,TraderOne,Tick,614,572,42,-42,150600,150600,12092,-15892,-15892,OK
111.771374,TraderOne,Tick,614,572,42,-42,150100,150600,12092,-15892,-28492,OK
112.035261,TraderOne,Tick,614,572,42,-42,150100,150600,12092,-15892,-28492,OK
112.272943,TraderOne,Tick,614,572,42,-42,150100,150500,12092,-15892,-28492,OK
112.451079,TraderOne,Tick,614,582,32,-32,150100,150400,12392,-20192,-29792,OK
112.750762,TraderOne,Tick,614,582,32,-32,150100,150500,12392,-20192,-29792,OK
113.037438,TraderOne,Tick,614,582,32,-32,150100,150700,12392,-20192,-29792,OK
113.228819,TraderOne,Tick,614,582,32,-32,150100,150600,12392,-20192,-29792,OK
113.54401,TraderOne,Tick,614,582,32,-32,150100,150500,12392,-20192,-29792,OK
113.74372,TraderOne,Tick,614,582,32,-32,150100,150500,12392,-20192,-29792,OK
114.029524,TraderOne,Tick,614,582,32,-32,150100,150500,12392,-20192,-29792,OK
114.226922,TraderOne,Tick,614,582,32,-32,150100,150600,12392,-20192,-29792,OK
114.496601,TraderOne,Tick,614,582,32,-32,150500,150500,12392,-20192,-20192,OK
114.727055,TraderOne,Tick,614,582,32,-32,150500,150500,12392,-20192,-20192,OK
115.023014,TraderOne,Tick,614,582,32,-32,150500,150900,12392,-20192,-29792,OK
115.29139,TraderOne,Tick,624,582,42,-42,150200,150500,12242,-21042,-33642,OK
115.54055,TraderOne,Tick,624,591,33,-33,150100,150500,12512,-24512,-34412,OK
115.753388,TraderOne,Tick,624,591,33,-33,150100,150500,12512,-24512,-34412,OK
116.045951,TraderOne,Tick,624,592,32,-32,150600,150400,12497,-24897,-18497,OK
116.283173,TraderOne,Tick,624,592,32,-32,150600,150500,12497,-24897,-21697,OK
116.477224,TraderOne,Tick,624,592,32,-32,150600,150800,12497,-24897,-31297,OK
116.731754,TraderOne,Tick,624,592,32,-32,150600,150800,12497,-24897,-31297,OK
117.019687,TraderOne,Tick,634,592,42,-42,150000,150500,12347,-22747,-35347,OK
117.234963,TraderOne,Tick,634,592,42,-42,150000,150500,12347,-22747,-35347,OK
117.464868,TraderOne,Tick,634,592,42,-42,150000,150300,12347,-22747,-35347,OK
117.749523,TraderOne,Tick,634,592,42,-42,150000,150300,12347,-22747,-35347,OK
117.996626,TraderOne,Tick,634,592,42,-42,150000,150300,12347,-22747,-35347,OK
118.252139,TraderOne,Tick,634,602,32,-32,150100,150500,12197,-26597,-36197,OK
118.52748,TraderOne,Tick,634,609,25,-25,150500,150500,12408,-26808,-26808,OK
118.704353,TraderOne,Tick,634,609,25,-25,150500,150400,12408,-26808,-24308,OK
118.980984,TraderOne,Tick,634,609,25,-25,150500,150300,12408,-26808,-21808,OK
119.295759,TraderOne,Tick,634,609,25,-25,150500,150300,12408,-26808,-21808,OK
119.517502,TraderOne,Tick,634,609,25,-25,150500,150300,12408,-26808,-21808,OK
119.704765,TraderOne,Tick,634,610,24,-24,150100,150100,12393,-26993,-26993,OK
120.014107,TraderOne,Tick,634,610,24,-24,150100,150100,12393,-26993,-26993,OK
120.219226,TraderOne,Tick,634,620,14,-14,150200,150600,12243,-34843,-39043,OK
120.500809,TraderOne,Tick,644,620,24,-24,150200,150600,12543,-31143,-38343,OK
120.762603,TraderOne,Tick,651,620,31,-31,150200,150600,12753,-29253,-38553,OK
120.97212,TraderOne,Tick,651,620,31,-31,150200,150600,12753,-29253,-38553,OK
121.261477,TraderOne,Tick,661,620,41,-41,150000,150600,12603,-26103,-38403,OK
121.492218,TraderOne,Tick,661,620,41,-41,150000,150600,12603,-26103,-38403,OK
121.791012,TraderOne,Tick,661,620,41,-41,150000,150600,12603,-26103,-38403,OK
121.970471,TraderOne,Tick,661,620,41,-41,150000,150600,12603,-26103,-38403,OK
122.214036,TraderOne,Tick,671,620,51,-51,150100,150600,12453,-22953,-38253,OK
122.461723,TraderOne,Tick,671,620,51,-51,150100,150500,12453,-22953,-38253,OK
122.741335,TraderOne,Tick,671,620,51,-51,150100,150500,12453,-22953,-38253,OK
122.986118,TraderOne,Tick,671,620,51,-51,150100,150500,12453,-22953,-38253,OK
123.291167,TraderOne,Tick,671,620,51,-51,150100,150400,12453,-22953,-38253,OK
123.490867,TraderOne,Tick,671,620,51,-51,150100,150400,12453,-22953,-38253,OK
123.747193,TraderOne,Tick,671,630,41,-41,150400,150400,12303,-27803,-27803,OK
123.957027,TraderOne,Tick,671,640,31,-31,150400,150400,12153,-31653,-31653,OK
124.244964,TraderOne,Tick,671,650,21,-21,150400,150400,12454,-32954,-32954,OK
124.500271,TraderOne,Tick,671,660,11,-11,150400,150400,12755,-34255,-34255,OK
124.755251,TraderOne,Tick,671,660,11,-11,150400,150400,12755,-34255,-34255,OK
124.974462,TraderOne,Tick,671,660,11,-11,150400,150400,12755,-34255,-34255,OK
125.244753,TraderOne,Tick,671,670,1,-1,150400,150400,13056,-35556,-35556,OK
125.514781,TraderOne,Tick,671,670,1,-1,150400,150400,13056,-35556,-35556,OK
125.704197,TraderOne,Tick,671,670,1,-1,150400,150400,13056,-35556,-35556,OK
125.978668,TraderOne,Tick,681,670,11,-11,150500,150700,13357,-35857,-38057,OK
126.257028,TraderOne,Tick,691,670,21,-21,150500,151100,13658,-35158,-41458,OK
126.476941,TraderOne,Tick,701,670,31,-31,150500,151200,13959,-29459,-38759,OK
126.793652,TraderOne,Tick,711,670,41,-41,150500,151000,14260,-24760,-37060,OK
126.980796,TraderOne,Tick,711,680,31,-31,150500,151000,14561,-29061,-38361,OK
127.27283,TraderOne,Tick,711,680,31,-31,150500,151000,14561,-29061,-38361,OK
127.494739,TraderOne,Tick,711,680,31,-31,150500,150700,14561,-29061,-35261,OK
127.714769,TraderOne,Tick,711,680,31,-31,150500,150400,14561,-29061,-25961,OK
127.994584,TraderOne,Tick,711,690,21,-21,150700,150300,14411,-30911,-24611,OK
128.265668,TraderOne,Tick,711,690,21,-21,150700,150300,14411,-30911,-24611,OK
128.530494,TraderOne,Tick,711,690,21,-21,150700,150200,14411,-30911,-24611,OK
128.764602,TraderOne,Tick,711,690,21,-21,150700,150200,14411,-30911,-24611,OK
129.033472,TraderOne,Tick,711,690,21,-21,150700,150200,14411,-30911,-24611,OK
129.292211,TraderOne,Tick,711,690,21,-21,150700,150200,14411,-30911,-24611,OK
129.490012,TraderOne,Tick,711,700,11,-11,151000,150400,14261,-32761,-29461,OK
129.714493,TraderOne,Tick,711,700,11,-11,151000,150400,14261,-32761,-29461,OK
130.010346,TraderOne,Tick,711,700,11,-11,151000,150400,14261,-32761,-29461,OK
130.203051,TraderOne,Tick,711,700,11,-11,151000,150400,14261,-32761,-29461,OK
130.465767,TraderOne,Tick,711,700,11,-11,151000,150400,14261,-32761,-29461,OK
130.759754,TraderOne,Tick,711,700,11,-11,151000,150400,14261,-32761,-29461,OK
131.048211,TraderOne,Tick,721,700,21,-21,149800,150400,14111,-31611,-37911,OK
131.205728,TraderOne,Tick,721,700,21,-21,149800,150100,14111,-31611,-37911,OK
131.548293,TraderOne,Tick,721,700,21,-21,149800,150100,14111,-31611,-37911,OK
131.719243,TraderOne,Tick,721,700,21,-21,149800,150100,14111,-31611,-37911,OK
131.99625,TraderOne,Tick,721,710,11,-11,150800,150100,13961,-32461,-29161,OK
132.213955,TraderOne,Tick,721,710,11,-11,150800,149800,13961,-32461,-29161,OK
132.502876,TraderOne,Tick,721,720,1,-1,149800,149800,14261,-33761,-33761,OK
132.763509,TraderOne,Tick,721,730,-9,9,149800,149600,14561,-33061,-34861,OK
133.019842,TraderOne,Tick,721,740,-19,19,149800,149600,14861,-31361,-35161,OK
133.270641,TraderOne,Tick,721,750,-29,29,150200,149600,14711,-29211,-35011,OK
133.537754,TraderOne,Tick,721,750,-29,29,150200,149600,14711,-29211,-35011,OK
133.770049,TraderOne,Tick,731,750,-19,19,149000,149500,14561,-32061,-28261,OK
134.047038,TraderOne,Tick,731,750,-19,19,149000,149600,14561,-32061,-28261,OK
134.210223,TraderOne,Tick,731,750,-19,19,149000,149600,14561,-32061,-28261,OK
134.520692,TraderOne,Tick,731,750,-19,19,149000,149700,14561,-32061,-28261,OK
134.751496,TraderOne,Tick,731,750,-19,19,149000,149700,14561,-32061,-28261,OK
134.994455,TraderOne,Tick,731,750,-19,19,149000,149800,14561,-32061,-26361,OK
135.284897,TraderOne,Tick,741,750,-9,9,149200,149800,14411,-34911,-32211,OK
135.469515,TraderOne,Tick,751,752,-1,1,149800,149800,14231,-34331,-34331,OK
135.795399,TraderOne,Tick,761,752,9,-9,149300,149900,14530,-29630,-32330,OK
136.000448,TraderOne,Tick,761,752,9,-9,149300,149900,14530,-29630,-32330,OK
136.296362,TraderOne,Tick,761,752,9,-9,149300,149900,14530,-29630,-32330,OK
136.529296,TraderOne,Tick,761,752,9,-9,149300,149900,14530,-29630,-32330,OK
136.711683,TraderOne,Tick,761,752,9,-9,149300,149800,14530,-29630,-32330,OK
136.976623,TraderOne,Tick,761,752,9,-9,149300,149600,14530,-29630,-31430,OK
137.248034,TraderOne,Tick,761,752,9,-9,149300,149600,14530,-29630,-31430,OK
137.539387,TraderOne,Tick,761,752,9,-9,149300,149600,14530,-29630,-31430,OK
137.783612,TraderOne,Tick,761,752,9,-9,149300,149300,14530,-29630,-29630,OK
138.012867,TraderOne,Tick,761,752,9,-9,149300,149300,14530,-29630,-29630,OK
138.252525,TraderOne,Tick,761,752,9,-9,149300,149300,14530,-29630,-29630,OK
138.515711,TraderOne,Tick,761,752,9,-9,149300,149300,14530,-29630,-29630,OK
138.714076,TraderOne,Tick,761,752,9,-9,149300,149100,14530,-29630,-27830,OK
139.005395,TraderOne,Tick,761,752,9,-9,149300,149100,14530,-29630,-27830,OK
139.23177,TraderOne,Tick,761,752,9,-9,149300,149100,14530,-29630,-27830,OK
139.494283,TraderOne,Tick,761,752,9,-9,149300,149300,14530,-29630,-29630,OK
139.758398,TraderOne,Tick,761,752,9,-9,149300,149300,14530,-29630,-29630,OK
140.007838,TraderOne,Tick,761,752,9,-9,149300,149300,14530,-29630,-29630,OK
140.261691,TraderOne,Tick,761,752,9,-9,149300,149300,14530,-29630,-29630,OK
140.477653,TraderOne,Tick,761,759,2,-2,149800,149300,14425,-29525,-29125,OK
140.735275,TraderOne,Tick,761,759,2,-2,149800,149300,14425,-29525,-29125,OK
141.044332,TraderOne,Tick,761,759,2,-2,149800,149300,14425,-29525,-29125,OK
141.289964,TraderOne,Tick,761,759,2,-2,149800,149300,14425,-29525,-29125,OK
141.503982,TraderOne,Tick,761,759,2,-2,149800,149300,14425,-29525,-29125,OK
141.719108,TraderOne,Tick,761,769,-8,8,150200,149500,14275,-29375,-30975,OK
141.958835,TraderOne,Tick,761,769,-8,8,150200,149500,14275,-29375,-30975,OK
142.234782,TraderOne,Tick,761,769,-8,8,150200,149500,14275,-29375,-30975,OK
142.541523,TraderOne,Tick,761,769,-8,8,150200,149500,14275,-29375,-30975,OK
142.780256,TraderOne,Tick,761,779,-18,18,150200,149500,14125,-28225,-31825,OK
142.976225,TraderOne,Tick,761,779,-18,18,150200,149500,14125,-28225,-31825,OK
143.224079,TraderOne,Tick,761,779,-18,18,150200,149500,14125,-28225,-31825,OK
143.466322,TraderOne,Tick,761,779,-18,18,150200,149700,14125,-28225,-31825,OK
143.779094,TraderOne,Tick,761,789,-28,28,150200,149700,13975,-26075,-31675,OK
143.971224,TraderOne,Tick,771,789,-18,18,149200,149700,13825,-28925,-25325,OK
144.202687,TraderOne,Tick,771,789,-18,18,149200,149700,13825,-28925,-25325,OK
144.451025,TraderOne,Tick,781,789,-8,8,149100,149700,13675,-30775,-29175,OK
144.777853,TraderOne,Tick,781,789,-8,8,149100,149700,13675,-30775,-29175,OK
145.014969,TraderOne,Tick,781,789,-8,8,149100,149700,13675,-30775,-29175,OK
145.255052,TraderOne,Tick,781,789,-8,8,149100,149700,13675,-30775,-29175,OK
145.458795,TraderOne,Tick,781,789,-8,8,149100,149700,13675,-30775,-29175,OK
145.797723,TraderOne,Tick,781,789,-8,8,149100,149700,13675,-30775,-29175,OK
145.998473,TraderOne,Tick,781,789,-8,8,149100,149700,13675,-30775,-29175,OK
146.243139,TraderOne,Tick,781,789,-8,8,149100,149700,13675,-30775,-29175,OK
146.465099,TraderOne,Tick,781,789,-8,8,149100,149500,13675,-30775,-29175,OK
146.768045,TraderOne,Tick,781,789,-8,8,149100,149700,13675,-30775,-29175,OK
147.026741,TraderOne,Tick,781,789,-8,8,149100,149700,13675,-30775,-29175,OK
147.262925,TraderOne,Tick,781,789,-8,8,149100,149700,13675,-30775,-29175,OK
147.486325,TraderOne,Tick,781,789,-8,8,149100,149600,13675,-30775,-29175,OK
147.771114,TraderOne,Tick,781,789,-8,8,149100,149600,13675,-30775,-29175,OK
147.984645,TraderOne,Tick,781,789,-8,8,149100,149600,13675,-30775,-29175,OK
148.264215,TraderOne,Tick,781,789,-8,8,149100,149600,13675,-30775,-29175,OK
148.503805,TraderOne,Tick,781,789,-8,8,149100,149600,13675,-30775,-29175,OK
148.791539,TraderOne,Tick,781,789,-8,8,149100,149600,13675,-30775,-29175,OK
149.030544,TraderOne,Tick,781,789,-8,8,149100,149600,13675,-30775,-29175,OK
149.210593,TraderOne,Tick,781,789,-8,8,149100,149600,13675,-30775,-29175,OK
149.504737,TraderOne,Tick,781,799,-18,18,150600,150100,13525,-27625,-33025,OK
149.748699,TraderOne,Tick,781,799,-18,18,150600,150100,13525,-27625,-33025,OK
150.000837,TraderOne,Tick,781,799,-18,18,150600,150100,13525,-27625,-33025,OK
150.216935,TraderOne,Tick,781,799,-18,18,150600,150100,13525,-27625,-33025,OK
150.516562,TraderOne,Tick,781,806,-25,25,150000,150100,13735,-26435,-23935,OK
150.792981,TraderOne,Tick,781,806,-25,25,150000,150100,13735,-26435,-23935,OK
150.992331,TraderOne,Tick,781,806,-25,25,150000,150100,13735,-26435,-23935,OK
151.24759,TraderOne,Tick,781,806,-25,25,150000,150100,13735,-26435,-23935,OK
151.542624,TraderOne,Tick,781,806,-25,25,150000,150100,13735,-26435,-23935,OK
151.764309,TraderOne,Tick,781,806,-25,25,150000,150100,13735,-26435,-23935,OK
151.952899,TraderOne,Tick,781,806,-25,25,150000,150100,13735,-26435,-23935,OK
152.217101,TraderOne,Tick,781,806,-25,25,150000,150100,13735,-26435,-23935,OK
152.466978,TraderOne,Tick,781,806,-25,25,150000,150100,13735,-26435,-23935,OK
152.794652,TraderOne,Tick,781,806,-25,25,150000,150100,13735,-26435,-23935,OK
153.036921,TraderOne,Tick,781,816,-35,35,150400,150100,13585,-23285,-33785,OK
153.286413,TraderOne,Tick,781,816,-35,35,150400,149800,13585,-23285,-33785,OK
153.545869,TraderOne,Tick,781,816,-35,35,150400,149800,13585,-23285,-33785,OK
153.717989,TraderOne,Tick,781,816,-35,35,150400,149800,13585,-23285,-33785,OK
153.950986,TraderOne,Tick,781,816,-35,35,150400,150100,13585,-23285,-33785,OK
154.20958,TraderOne,Tick,781,816,-35,35,150400,150100,13585,-23285,-33785,OK
154.502609,TraderOne,Tick,781,816,-35,35,150400,150100,13585,-23285,-33785,OK
154.786458,TraderOne,Tick,781,816,-35,35,150400,150100,13585,-23285,-33785,OK
154.994931,TraderOne,Tick,791,816,-25,25,150600,150100,13886,-26586,-34086,OK
155.236417,TraderOne,Tick,801,816,-15,15,150600,150100,14187,-29887,-34387,OK
155.476691,TraderOne,Tick,801,816,-15,15,150600,150300,14187,-29887,-34387,OK
155.715997,TraderOne,Tick,801,816,-15,15,150600,150300,14187,-29887,-34387,OK
155.997708,TraderOne,Tick,801,816,-15,15,150600,150300,14187,-29887,-34387,OK
156.284506,TraderOne,Tick,801,816,-15,15,150600,150300,14187,-29887,-34387,OK
156.537824,TraderOne,Tick,801,816,-15,15,150600,150300,14187,-29887,-34387,OK
156.728142,TraderOne,Tick,801,816,-15,15,150600,150300,14187,-29887,-34387,OK
156.998443,TraderOne,Tick,801,816,-15,15,150600,150300,14187,-29887,-34387,OK
157.243035,TraderOne,Tick,801,816,-15,15,150600,150300,14187,-29887,-34387,OK
157.515182,TraderOne,Tick,801,816,-15,15,150600,150300,14187,-29887,-34387,OK
157.729026,TraderOne,Tick,801,816,-15,15,150600,150300,14187,-29887,-34387,OK
158.031703,TraderOne,Tick,801,816,-15,15,150600,150300,14187,-29887,-34387,OK
158.295626,TraderOne,Tick,801,816,-15,15,150600,150300,14187,-29887,-34387,OK
158.519355,TraderOne,Tick,801,816,-15,15,150500,150300,14187,-29887,-32887,OK
158.719831,TraderOne,Tick,801,816,-15,15,150500,150300,14187,-29887,-32887,OK
159.045328,TraderOne,Tick,811,816,-5,5,150600,150400,14488,-32188,-33188,OK
159.292888,TraderOne,Tick,811,826,-15,15,150500,150400,14789,-31489,-32989,OK
159.53714,TraderOne,Tick,811,826,-15,15,150500,150400,14789,-31489,-32989,OK
159.717465,TraderOne,Tick,820,826,-6,6,150600,150400,15060,-33560,-34760,OK
160.035509,TraderOne,Tick,820,826,-6,6,150600,150400,15060,-33560,-34760,OK
160.297826,TraderOne,Tick,820,828,-8,8,150700,150400,15030,-33130,-35530,OK
160.491697,TraderOne,Tick,820,834,-14,14,150600,150400,14940,-31840,-34640,OK
160.724454,TraderOne,Tick,820,834,-14,14,150600,150200,14940,-31840,-36040,OK
161.041545,TraderOne,Tick,820,842,-22,22,150500,150200,15181,-30481,-37081,OK
161.260902,TraderOne,Tick,820,842,-22,22,150500,150200,15181,-30481,-37081,OK
161.480386,TraderOne,Tick,820,842,-22,22,150500,150200,15181,-30481,-37081,OK
161.793425,TraderOne,Tick,820,842,-22,22,150500,150200,15181,-30481,-37081,OK
162.044262,TraderOne,Tick,820,842,-22,22,150500,150200,15181,-30481,-37081,OK
162.239377,TraderOne,Tick,830,842,-12,12,150800,150700,15483,-33783,-34983,OK
162.463988,TraderOne,Tick,830,842,-12,12,150800,150800,15483,-33783,-33783,OK
162.711558,TraderOne,Tick,830,842,-12,12,150800,150800,15483,-33783,-33783,OK
162.993274,TraderOne,Tick,830,842,-12,12,150800,150700,15483,-33783,-34983,OK
163.298473,TraderOne,Tick,831,842,-11,11,150800,150600,15468,-33868,-36068,OK
163.547544,TraderOne,Tick,831,842,-11,11,150800,150800,15468,-33868,-33868,OK
163.733716,TraderOne,Tick,831,842,-11,11,150800,150800,15468,-33868,-33868,OK
164.037055,TraderOne,Tick,841,842,-1,1,151000,151000,15770,-37170,-37170,OK
164.267796,TraderOne,Tick,851,842,9,-9,151000,151000,16072,-39472,-39472,OK
164.475442,TraderOne,Tick,851,842,9,-9,151000,151000,16072,-39472,-39472,OK
164.799833,TraderOne,Tick,851,852,-1,1,151200,150900,15921,-40321,-40621,OK
164.976709,TraderOne,Tick,851,852,-1,1,151200,151000,15921,-40321,-40521,OK
165.279627,TraderOne,Tick,851,862,-11,11,151400,151000,15770,-38170,-41470,OK
165.516456,TraderOne,Tick,851,862,-11,11,151400,151000,15770,-38170,-41470,OK
165.793135,TraderOne,Tick,851,862,-11,11,151400,151000,15770,-38170,-41470,OK
165.974503,TraderOne,Tick,851,862,-11,11,151400,151000,15770,-38170,-41470,OK
166.284423,TraderOne,Tick,851,862,-11,11,151400,151100,15770,-38170,-41470,OK
166.499299,TraderOne,Tick,851,862,-11,11,151400,151100,15770,-38170,-41470,OK
166.710153,TraderOne,Tick,851,862,-11,11,151400,151100,15770,-38170,-41470,OK
167.030217,TraderOne,Tick,851,862,-11,11,151400,151100,15770,-38170,-41470,OK
167.259589,TraderOne,Tick,851,862,-11,11,151400,151100,15770,-38170,-41470,OK
167.512433,TraderOne,Tick,851,862,-11,11,151400,151100,15770,-38170,-41470,OK
167.74151,TraderOne,Tick,861,862,-1,1,151500,151100,16073,-40473,-40773,OK
167.993749,TraderOne,Tick,861,862,-1,1,151500,151100,16073,-40473,-40773,OK
168.272655,TraderOne,Tick,861,862,-1,1,151500,151100,16073,-40473,-40773,OK
168.46323,TraderOne,Tick,861,862,-1,1,151500,151100,16073,-40473,-40773,OK
168.708996,TraderOne,Tick,861,862,-1,1,151500,151100,16073,-40473,-40773,OK
169.039511,TraderOne,Tick,861,862,-1,1,151500,151100,16073,-40473,-40773,OK
169.254701,TraderOne,Tick,861,872,-11,11,151100,150500,15922,-39322,-42622,OK
169.492126,TraderOne,Tick,861,872,-11,11,151100,150500,15922,-39322,-42622,OK
169.773497,TraderOne,Tick,861,872,-11,11,151100,150800,15922,-39322,-42622,OK
170.01042,TraderOne,Tick,861,872,-11,11,151100,150700,15922,-39322,-42622,OK
170.207656,TraderOne,Tick,861,872,-11,11,151100,150700,15922,-39322,-42622,OK
170.549063,TraderOne,Tick,861,872,-11,11,151100,150700,15922,-39322,-42622,OK
170.792169,TraderOne,Tick,861,872,-11,11,151100,150500,15922,-39322,-42622,OK
170.952542,TraderOne,Tick,861,872,-11,11,151100,150500,15922,-39322,-42622,OK
171.297179,TraderOne,Tick,861,872,-11,11,151100,150500,15922,-39322,-42622,OK
171.458766,TraderOne,Tick,861,872,-11,11,151100,150500,15922,-39322,-42622,OK
171.733113,TraderOne,Tick,865,872,-7,7,150700,150500,15862,-40062,-41462,OK
171.975407,TraderOne,Tick,875,882,-7,7,151200,150500,15560,-39760,-41860,OK
172.261329,TraderOne,Tick,875,882,-7,7,151200,150500,15560,-39760,-41860,OK
172.470266,TraderOne,Tick,875,882,-7,7,151200,150500,15560,-39760,-41860,OK
172.73142,TraderOne,Tick,875,892,-17,17,151000,150500,15409,-38609,-43709,OK
173.046608,TraderOne,Tick,875,892,-17,17,151000,150500,15409,-38609,-43709,OK
173.24595,TraderOne,Tick,875,892,-17,17,151000,150500,15409,-38609,-43709,OK
173.51186,TraderOne,Tick,875,892,-17,17,151000,150500,15409,-38609,-43709,OK
173.774508,TraderOne,Tick,875,892,-17,17,151000,150500,15409,-38609,-43709,OK
174.031979,TraderOne,Tick,875,892,-17,17,151000,150500,15409,-38609,-43709,OK
174.267973,TraderOne,Tick,875,892,-17,17,151000,150500,15409,-38609,-43709,OK
174.50655,TraderOne,Tick,875,892,-17,17,151000,150500,15409,-38609,-43709,OK
174.716683,TraderOne,Tick,875,892,-17,17,151000,150600,15409,-38609,-43709,OK
174.953246,TraderOne,Tick,885,892,-7,7,150800,150600,15711,-40911,-42311,OK
175.214875,TraderOne,Tick,885,892,-7,7,150800,150600,15711,-40911,-42311,OK
175.537653,TraderOne,Tick,885,892,-7,7,150800,150600,15711,-40911,-42311,OK
175.716661,TraderOne,Tick,885,892,-7,7,150800,150600,15711,-40911,-42311,OK
176.015168,TraderOne,Tick,885,892,-7,7,150800,150600,15711,-40911,-42311,OK
176.273059,TraderOne,Tick,885,892,-7,7,150800,150600,15711,-40911,-42311,OK
176.512847,TraderOne,Tick,895,892,3,-3,150700,150600,15560,-41760,-41460,OK
176.795581,TraderOne,Tick,895,892,3,-3,150700,150600,15560,-41760,-41460,OK
177.046139,TraderOne,Tick,895,892,3,-3,150700,150600,15560,-41760,-41460,OK
177.224534,TraderOne,Tick,895,892,3,-3,150700,150600,15560,-41760,-41460,OK
177.537329,TraderOne,Tick,895,902,-7,7,151200,150600,15409,-41609,-43709,OK
177.701083,TraderOne,Tick,895,902,-7,7,151200,150500,15409,-41609,-43709,OK
178.006966,TraderOne,Tick,895,902,-7,7,151200,150300,15409,-41609,-43709,OK
178.264613,TraderOne,Tick,895,902,-7,7,151200,150300,15409,-41609,-43709,OK
178.45785,TraderOne,Tick,895,902,-7,7,151200,150200,15409,-41609,-43709,OK
178.725301,TraderOne,Tick,895,912,-17,17,150400,150200,15710,-39910,-43310,OK
179.021638,TraderOne,Tick,895,922,-27,27,150400,150200,16011,-38211,-43611,OK
179.286694,TraderOne,Tick,895,922,-27,27,150400,150200,16011,-38211,-43611,OK
179.502959,TraderOne,Tick,895,922,-27,27,150400,149900,16011,-38211,-46311,OK
179.723032,TraderOne,Tick,895,922,-27,27,150400,149900,16011,-38211,-46311,OK
180.013872,TraderOne,Tick,895,922,-27,27,150100,149900,16011,-38211,-43611,OK
180.281806,TraderOne,Tick,904,932,-28,28,150100,149800,15726,-38526,-46926,OK
180.531006,TraderOne,Tick,904,932,-28,28,150100,149800,15726,-38526,-46926,OK
180.771915,TraderOne,Tick,904,932,-28,28,150100,149900,15726,-38526,-44126,OK
181.012298,TraderOne,Tick,904,932,-28,28,150100,149900,15726,-38526,-44126,OK
181.225083,TraderOne,Tick,904,932,-28,28,150100,149900,15726,-38526,-44126,OK
181.468624,TraderOne,Tick,914,932,-18,18,149700,149900,15576,-42376,-38776,OK
181.774103,TraderOne,Tick,914,932,-18,18,149700,149900,15576,-42376,-38776,OK
181.960698,TraderOne,Tick,914,932,-18,18,149700,149900,15576,-42376,-38776,OK
182.209103,TraderOne,Tick,914,932,-18,18,149700,149900,15576,-42376,-38776,OK
182.496554,TraderOne,Tick,914,932,-18,18,149700,149900,15576,-42376,-38776,OK
182.706332,TraderOne,Tick,914,932,-18,18,149700,149900,15576,-42376,-38776,OK
183.011275,TraderOne,Tick,914,932,-18,18,149700,149900,15576,-42376,-38776,OK
183.228289,TraderOne,Tick,914,932,-18,18,149700,149900,15576,-42376,-38776,OK
183.453958,TraderOne,Tick,914,932,-18,18,149700,150000,15576,-42376,-36976,OK
183.707697,TraderOne,Tick,924,932,-8,8,150100,150000,15426,-44226,-45026,OK
184.031863,TraderOne,Tick,927,932,-5,5,150100,150000,15381,-44481,-44981,OK
184.226377,TraderOne,Tick,927,932,-5,5,150100,149700,15381,-44481,-45481,OK
184.537313,TraderOne,Tick,927,932,-5,5,150100,149700,15381,-44481,-45481,OK
184.74471,TraderOne,Tick,947,932,15,-15,149700,149700,15530,-42630,-42630,OK
185.042015,TraderOne,Tick,957,932,25,-25,149700,150000,15829,-41929,-49429,OK
185.292937,TraderOne,Tick,957,932,25,-25,149700,150000,15829,-41929,-49429,OK
185.460898,TraderOne,Tick,957,932,25,-25,149700,150000,15829,-41929,-49429,OK
185.730061,TraderOne,Tick,957,932,25,-25,149700,150000,15829,-41929,-49429,OK
186.039626,TraderOne,Tick,957,932,25,-25,149700,150000,15829,-41929,-49429,OK
186.22022,TraderOne,Tick,957,932,25,-25,149700,149800,15829,-41929,-44429,OK
186.533676,TraderOne,Tick,957,942,15,-15,149600,149800,16128,-44228,-47228,OK
186.762426,TraderOne,Tick,957,942,15,-15,149600,149800,16128,-44228,-47228,OK
187.036013,TraderOne,Tick,967,942,25,-25,149700,149800,16427,-43527,-46027,OK
187.227998,TraderOne,Tick,967,942,25,-25,149700,149800,16427,-43527,-46027,OK
187.531589,TraderOne,Tick,967,942,25,-25,149700,150000,16427,-43527,-51027,OK
187.796332,TraderOne,Tick,977,942,35,-35,149700,150000,16726,-40826,-51326,OK
187.999201,TraderOne,Tick,987,942,45,-45,149700,150000,17025,-38125,-51625,OK
188.220227,TraderOne,Tick,993,942,51,-51,149700,150100,16935,-34435,-49735,OK
188.540574,TraderOne,Tick,1001,942,59,-59,149700,150100,17175,-30675,-48375,OK
188.765242,TraderOne,Tick,1001,942,59,-59,149700,150100,17175,-30675,-48375,OK
188.969398,TraderOne,Tick,1001,942,59,-59,149700,150200,17175,-30675,-48375,OK
189.231991,TraderOne,Tick,1001,942,59,-59,149700,150200,17175,-30675,-48375,OK
189.474951,TraderOne,Tick,1001,952,49,-49,149800,150200,17025,-37525,-52225,OK
189.764825,TraderOne,Tick,1001,952,49,-49,149800,150200,17025,-37525,-52225,OK
190.048683,TraderOne,Tick,1011,952,59,-59,150000,150200,17325,-34825,-46625,OK
190.294021,TraderOne,Tick,1011,952,59,-59,150000,150300,17325,-34825,-52525,OK
190.541213,TraderOne,Tick,1011,952,59,-59,150000,150300,17325,-34825,-52525,OK
190.748001,TraderOne,Tick,1011,952,59,-59,150000,150300,17325,-34825,-52525,OK
190.967129,TraderOne,Tick,1011,952,59,-59,150000,150300,17325,-34825,-52525,OK
191.20527,TraderOne,Tick,1011,952,59,-59,149500,150400,17325,-34825,-52525,OK
191.537742,TraderOne,Tick,1021,952,69,-69,150000,150700,17625,-29125,-49825,OK
191.719656,TraderOne,Tick,1021,952,69,-69,150000,150800,17625,-29125,-49825,OK
192.035382,TraderOne,Tick,1021,962,59,-59,150200,150800,17925,-35425,-53125,OK
192.27844,TraderOne,Tick,1021,962,59,-59,150200,150700,17925,-35425,-53125,OK
192.508084,TraderOne,Tick,1021,962,59,-59,150200,150700,17925,-35425,-53125,OK
192.780404,TraderOne,Tick,1021,962,59,-59,150300,150700,17925,-35425,-53125,OK
192.986309,TraderOne,Tick,1021,962,59,-59,150300,150500,17925,-35425,-47225,OK
193.222459,TraderOne,Tick,1031,972,59,-59,150200,150500,18075,-37575,-55275,OK
193.513845,TraderOne,Tick,1031,972,59,-59,150200,150500,18075,-37575,-55275,OK
193.73804,TraderOne,Tick,1031,972,59,-59,150200,150500,18075,-37575,-55275,OK
194.032129,TraderOne,Tick,1031,972,59,-59,150200,150500,18075,-37575,-55275,OK
194.300331,TraderOne,Tick,1031,982,49,-49,150000,150500,17925,-46425,-61125,OK
194.516956,TraderOne,Tick,1031,982,49,-49,150000,150500,17925,-46425,-61125,OK
194.762,TraderOne,Tick,1031,982,49,-49,150000,150500,17925,-46425,-61125,OK
195.0135,TraderOne,Tick,1031,982,49,-49,150000,150600,17925,-46425,-61125,OK
195.299735,TraderOne,Tick,1031,982,49,-49,150000,150600,17925,-46425,-61125,OK
195.532752,TraderOne,Tick,1031,982,49,-49,150000,150600,17925,-46425,-61125,OK
195.714527,TraderOne,Tick,1031,982,49,-49,150000,150600,17925,-46425,-61125,OK
195.95557,TraderOne,Tick,1031,982,49,-49,150000,150600,17925,-46425,-61125,OK
196.290219,TraderOne,Tick,1031,982,49,-49,150000,150600,17925,-46425,-61125,OK
196.459657,TraderOne,Tick,1031,982,49,-49,149800,150600,17925,-46425,-61125,OK
196.719247,TraderOne,Tick,1031,982,49,-49,149800,150100,17925,-46425,-61125,OK
197.048728,TraderOne,Tick,1031,982,49,-49,149800,150000,17925,-46425,-56225,OK
197.287038,TraderOne,Tick,1031,982,49,-49,149800,150000,17925,-46425,-56225,OK
197.4832,TraderOne,Tick,1031,992,39,-39,149500,150000,18224,-50724,-62424,OK
197.779524,TraderOne,Tick,1031,992,39,-39,149500,149800,18224,-50724,-62424,OK
198.048426,TraderOne,Tick,1031,992,39,-39,149500,149700,18224,-50724,-58524,OK
198.275897,TraderOne,Tick,1031,1002,29,-29,149500,149700,18523,-54023,-59823,OK
198.451325,TraderOne,Tick,1031,1012,19,-19,149500,149500,18822,-56322,-56322,OK
198.774019,TraderOne,Tick,1031,1022,9,-9,149500,149500,19121,-57621,-57621,OK
198.982912,TraderOne,Tick,1031,1032,-1,1,149500,149500,19420,-58920,-58920,OK
199.2185,TraderOne,Tick,1031,1032,-1,1,149500,149500,19420,-58920,-58920,OK
199.547412,TraderOne,Tick,1031,1032,-1,1,149500,149500,19420,-58920,-58920,OK
199.716061,TraderOne,Tick,1031,1032,-1,1,149500,149500,19420,-58920,-58920,OK
199.981099,TraderOne,Tick,1031,1032,-1,1,149500,149500,19420,-58920,-58920,OK
200.294291,TraderOne,Tick,1031,1032,-1,1,149500,149600,19420,-58920,-58820,OK
200.470332,TraderOne,Tick,1031,1036,-5,5,149800,149600,19360,-58460,-59460,OK
200.744891,TraderOne,Tick,1031,1036,-5,5,149800,149600,19360,-58460,-59460,OK
201.011384,TraderOne,Tick,1031,1036,-5,5,149800,149600,19360,-58460,-59460,OK
201.278548,TraderOne,Tick,1031,1037,-6,6,149900,149600,19345,-58345,-59545,OK
201.510131,TraderOne,Tick,1031,1037,-6,6,149900,149800,19345,-58345,-58945,OK
201.766121,TraderOne,Tick,1041,1037,4,-4,149300,150000,19195,-57195,-58395,OK
201.955624,TraderOne,Tick,1041,1037,4,-4,149300,150000,19195,-57195,-58395,OK
202.264876,TraderOne,Tick,1041,1037,4,-4,149300,150200,19195,-57195,-58395,OK
202.542263,TraderOne,Tick,1041,1037,4,-4,149300,150200,19195,-57195,-58395,OK
202.779986,TraderOne,Tick,1051,1037,14,-14,150500,150600,19496,-57496,-58896,OK
203.00165,TraderOne,Tick,1061,1037,24,-24,150500,150600,19797,-56797,-59197,OK
203.228332,TraderOne,Tick,1061,1037,24,-24,150500,150600,19797,-56797,-59197,OK
203.473957,TraderOne,Tick,1061,1037,24,-24,150500,150600,19797,-56797,-59197,OK
203.78801,TraderOne,Tick,1061,1037,24,-24,150500,150600,19797,-56797,-59197,OK
203.956331,TraderOne,Tick,1061,1037,24,-24,150500,150600,19797,-56797,-59197,OK
204.205489,TraderOne,Tick,1071,1037,34,-34,150200,150600,19647,-54647,-64847,OK
204.461151,TraderOne,Tick,1071,1037,34,-34,150200,150600,19647,-54647,-64847,OK
204.763554,TraderOne,Tick,1071,1037,34,-34,150200,150600,19647,-54647,-64847,OK
205.032273,TraderOne,Tick,1080,1037,43,-43,150100,150100,19512,-55412,-55412,OK
205.274509,TraderOne,Tick,1080,1047,33,-33,149700,149700,19811,-57711,-57711,OK
205.512738,TraderOne,Tick,1080,1057,23,-23,150400,149700,19661,-59561,-54961,OK
205.788687,TraderOne,Tick,1080,1057,23,-23,150400,149700,19661,-59561,-54961,OK
205.965446,TraderOne,Tick,1080,1057,23,-23,150400,149800,19661,-59561,-52661,OK
206.288737,TraderOne,Tick,1080,1067,13,-13,150300,149800,19511,-61411,-57511,OK
206.544395,TraderOne,Tick,1080,1067,13,-13,150300,149800,19511,-61411,-57511,OK
206.737636,TraderOne,Tick,1080,1067,13,-13,150300,149800,19511,-61411,-57511,OK
207.048813,TraderOne,Tick,1080,1067,13,-13,150300,149800,19511,-61411,-57511,OK
207.258469,TraderOne,Tick,1080,1067,13,-13,150300,149800,19511,-61411,-57511,OK
207.484511,TraderOne,Tick,1080,1067,13,-13,150300,149800,19511,-61411,-57511,OK
207.748171,TraderOne,Tick,1080,1067,13,-13,150300,149800,19511,-61411,-57511,OK
207.952605,TraderOne,Tick,1080,1067,13,-13,150300,149800,19511,-61411,-57511,OK
208.291078,TraderOne,Tick,1090,1077,13,-13,149200,149800,19660,-61560,-65460,OK
208.467964,TraderOne,Tick,1090,1077,13,-13,149200,149800,19660,-61560,-65460,OK
208.742876,TraderOne,Tick,1090,1087,3,-3,149800,149800,19510,-62410,-62410,OK
208.994363,TraderOne,Tick,1090,1087,3,-3,149800,149800,19510,-62410,-62410,OK
209.296494,TraderOne,Tick,1090,1087,3,-3,149800,149800,19510,-62410,-62410,OK
209.542974,TraderOne,Tick,1090,1087,3,-3,149800,149800,19510,-62410,-62410,OK
209.71475,TraderOne,Tick,1090,1097,-7,7,150300,149800,19360,-62260,-64360,OK
210.037304,TraderOne,Tick,1090,1097,-7,7,150300,149800,19360,-62260,-64360,OK
210.207843,TraderOne,Tick,1090,1097,-7,7,150300,149800,19360,-62260,-64360,OK
210.511388,TraderOne,Tick,1090,1097,-7,7,150300,149800,19360,-62260,-64360,OK
210.717081,TraderOne,Tick,1090,1097,-7,7,150300,149800,19360,-62260,-64360,OK
210.984637,TraderOne,Tick,1090,1107,-17,17,150400,149900,19210,-61110,-66210,OK
211.244324,TraderOne,Tick,1090,1116,-26,26,150200,149900,19480,-58680,-66480,OK
211.45503,TraderOne,Tick,1090,1116,-26,26,150200,149900,19480,-58680,-66480,OK
211.771669,TraderOne,Tick,1100,1116,-16,16,150000,149600,19330,-64530,-67730,OK
212.045876,TraderOne,Tick,1110,1116,-6,6,149100,149700,19180,-66380,-65180,OK
212.240315,TraderOne,Tick,1110,1116,-6,6,149100,149700,19180,-66380,-65180,OK
212.509048,TraderOne,Tick,1110,1116,-6,6,149100,149700,19180,-66380,-65180,OK
212.789004,TraderOne,Tick,1110,1126,-16,16,150200,149700,19030,-65230,-68430,OK
212.992453,TraderOne,Tick,1110,1126,-16,16,150200,149700,19030,-65230,-68430,OK
213.271317,TraderOne,Tick,1110,1126,-16,16,150200,149300,19030,-65230,-68430,OK
213.515658,TraderOne,Tick,1110,1126,-16,16,150200,149300,19030,-65230,-68430,OK
213.764138,TraderOne,Tick,1110,1126,-16,16,150200,149300,19030,-65230,-68430,OK
213.951572,TraderOne,Tick,1110,1126,-16,16,150200,149300,19030,-65230,-68430,OK
214.281532,TraderOne,Tick,1110,1126,-16,16,150200,149300,19030,-65230,-68430,OK
214.531303,TraderOne,Tick,1110,1126,-16,16,150200,149600,19030,-65230,-68430,OK
214.734271,TraderOne,Tick,1110,1126,-16,16,150200,149600,19030,-65230,-68430,OK
214.97741,TraderOne,Tick,1110,1126,-16,16,150200,149600,19030,-65230,-68430,OK
215.275317,TraderOne,Tick,1110,1126,-16,16,150200,149600,19030,-65230,-68430,OK
215.468602,TraderOne,Tick,1110,1126,-16,16,150200,149600,19030,-65230,-68430,OK
215.719183,TraderOne,Tick,1110,1126,-16,16,150200,149600,19030,-65230,-68430,OK
216.041546,TraderOne,Tick,1116,1126,-10,10,149500,149600,18940,-66940,-65940,OK
216.265176,TraderOne,Tick,1116,1126,-10,10,149500,149400,18940,-66940,-67940,OK
216.463652,TraderOne,Tick,1116,1126,-10,10,149500,149400,18940,-66940,-67940,OK
216.799447,TraderOne,Tick,1116,1126,-10,10,149500,150000,18940,-66940,-63940,OK
217.045748,TraderOne,Tick,1136,1126,10,-10,149700,150000,19090,-60090,-63090,OK
217.244064,TraderOne,Tick,1146,1126,20,-20,149500,150000,19389,-56389,-62389,OK
217.45797,TraderOne,Tick,1156,1126,30,-30,149500,150100,19688,-52688,-61688,OK
217.749398,TraderOne,Tick,1159,1126,33,-33,149700,150100,19778,-51578,-61478,OK
218.024212,TraderOne,Tick,1159,1126,33,-33,149700,149900,19778,-51578,-58178,OK
218.282804,TraderOne,Tick,1159,1126,33,-33,149700,149900,19778,-51578,-58178,OK
218.510286,TraderOne,Tick,1159,1126,33,-33,149700,149900,19778,-51578,-58178,OK
218.772119,TraderOne,Tick,1159,1126,33,-33,149700,149900,19778,-51578,-58178,OK
218.973524,TraderOne,Tick,1159,1126,33,-33,149700,149900,19778,-51578,-58178,OK
219.286863,TraderOne,Tick,1159,1136,23,-23,150500,149900,19628,-54428,-47528,OK
219.478365,TraderOne,Tick,1159,1146,13,-13,150400,149900,19478,-56278,-52378,OK
219.760654,TraderOne,Tick,1159,1146,13,-13,150400,149900,19478,-56278,-52378,OK
220.009489,TraderOne,Tick,1159,1156,3,-3,150500,149900,19328,-57128,-56228,OK
220.289633,TraderOne,Tick,1159,1156,3,-3,150500,149900,19328,-57128,-56228,OK
220.535596,TraderOne,Tick,1159,1156,3,-3,150500,149900,19328,-57128,-56228,OK
220.768127,TraderOne,Tick,1159,1156,3,-3,150500,149900,19328,-57128,-56228,OK
221.011921,TraderOne,Tick,1159,1166,-7,7,150500,150000,19178,-58978,-61078,OK
221.286653,TraderOne,Tick,1159,1166,-7,7,150500,150000,19178,-58978,-61078,OK
221.47063,TraderOne,Tick,1159,1166,-7,7,150500,150100,19178,-58978,-61078,OK
221.719409,TraderOne,Tick,1159,1166,-7,7,150500,150100,19178,-58978,-61078,OK
222.010137,TraderOne,Tick,1159,1166,-7,7,150500,150100,19178,-58978,-61078,OK
222.270283,TraderOne,Tick,1159,1166,-7,7,150500,150100,19178,-58978,-61078,OK
222.491137,TraderOne,Tick,1159,1166,-7,7,150500,150100,19178,-58978,-61078,OK
222.761653,TraderOne,Tick,1169,1166,3,-3,149500,150000,19028,-59828,-60728,OK
223.029456,TraderOne,Tick,1169,1176,-7,7,150100,150000,19328,-60128,-60828,OK
223.27416,TraderOne,Tick,1169,1176,-7,7,150100,150000,19328,-60128,-60828,OK
223.508882,TraderOne,Tick,1169,1176,-7,7,150100,150000,19328,-60128,-60828,OK
223.742109,TraderOne,Tick,1169,1186,-17,17,150100,150000,19628,-59428,-61128,OK
224.038699,TraderOne,Tick,1169,1196,-27,27,150400,150000,19929,-57729,-65829,OK
224.2958,TraderOne,Tick,1169,1206,-37,37,150400,150000,20230,-54030,-65130,OK
224.47474,TraderOne,Tick,1169,1212,-43,43,150400,150000,20410,-51810,-64710,OK
224.719665,TraderOne,Tick,1169,1212,-43,43,150400,149800,20410,-51810,-64710,OK
225.046996,TraderOne,Tick,1179,1212,-33,33,150100,149400,20260,-59660,-66260,OK
225.22437,TraderOne,Tick,1179,1212,-33,33,150100,149500,20260,-59660,-66260,OK
225.543356,TraderOne,Tick,1179,1212,-33,33,150100,149500,20260,-59660,-66260,OK
225.785304,TraderOne,Tick,1179,1212,-33,33,150100,149500,20260,-59660,-66260,OK
225.997328,TraderOne,Tick,1179,1212,-33,33,150100,149500,20260,-59660,-66260,OK
226.224862,TraderOne,Tick,1189,1212,-23,23,149300,149500,20110,-63510,-58910,OK
226.477328,TraderOne,Tick,1189,1212,-23,23,149300,149500,20110,-63510,-58910,OK
226.703245,TraderOne,Tick,1189,1222,-33,33,150300,149500,19960,-61360,-67960,OK
227.024449,TraderOne,Tick,1189,1222,-33,33,150300,149500,19960,-61360,-67960,OK
227.234527,TraderOne,Tick,1189,1222,-33,33,150300,149500,19960,-61360,-67960,OK
227.494926,TraderOne,Tick,1199,1222,-23,23,150400,150200,20261,-66661,-71261,OK
227.756406,TraderOne,Tick,1204,1222,-18,18,150500,150200,20411,-68311,-73711,OK
228.013254,TraderOne,Tick,1214,1222,-8,8,150600,150800,20712,-67612,-66012,OK
228.217178,TraderOne,Tick,1224,1222,2,-2,150600,150600,21013,-66913,-66913,OK
228.480118,TraderOne,Tick,1234,1222,12,-12,150600,150600,21314,-66214,-66214,OK
228.748168,TraderOne,Tick,1234,1222,12,-12,150600,150600,21314,-66214,-66214,OK
228.996095,TraderOne,Tick,1238,1222,16,-16,150500,150600,21254,-65354,-66954,OK
229.202365,TraderOne,Tick,1248,1222,26,-26,150600,150600,21555,-64655,-64655,OK
229.528894,TraderOne,Tick,1248,1222,26,-26,150600,150600,21555,-64655,-64655,OK
229.765829,TraderOne,Tick,1248,1222,26,-26,150600,150600,21555,-64655,-64655,OK
230.008864,TraderOne,Tick,1248,1222,26,-26,150600,150600,21555,-64655,-64655,OK
230.220631,TraderOne,Tick,1248,1222,26,-26,150600,150700,21555,-64655,-67255,OK
230.468912,TraderOne,Tick,1248,1222,26,-26,150600,150700,21555,-64655,-67255,OK
230.741821,TraderOne,Tick,1248,1222,26,-26,150600,150700,21555,-64655,-67255,OK
231.034866,TraderOne,Tick,1248,1222,26,-26,150600,150700,21555,-64655,-67255,OK
231.294336,TraderOne,Tick,1248,1222,26,-26,150600,150700,21555,-64655,-67255,OK
231.541189,TraderOne,Tick,1248,1222,26,-26,150600,150700,21555,-64655,-67255,OK
231.786471,TraderOne,Tick,1248,1222,26,-26,150600,150700,21555,-64655,-67255,OK
231.962556,TraderOne,Tick,1248,1222,26,-26,150600,150700,21555,-64655,-67255,OK
232.211861,TraderOne,Tick,1248,1222,26,-26,150600,150700,21555,-64655,-67255,OK
232.501249,TraderOne,Tick,1248,1222,26,-26,150600,150700,21555,-64655,-67255,OK
232.780944,TraderOne,Tick,1258,1222,36,-36,150600,150700,21856,-62956,-66556,OK
233.021672,TraderOne,Tick,1258,1222,36,-36,150600,150700,21856,-62956,-66556,OK
233.254273,TraderOne,Tick,1268,1222,46,-46,150700,151100,22158,-59758,-73558,OK
233.506477,TraderOne,Tick,1268,1222,46,-46,150700,151100,22158,-59758,-73558,OK
233.70428,TraderOne,Tick,1268,1222,46,-46,150700,151100,22158,-59758,-73558,OK
233.952783,TraderOne,Tick,1268,1222,46,-46,150700,151100,22158,-59758,-73558,OK
234.276376,TraderOne,Tick,1268,1222,46,-46,150700,151100,22158,-59758,-73558,OK
234.495194,TraderOne,Tick,1278,1222,56,-56,150700,151200,22459,-56059,-72859,OK
234.766537,TraderOne,Tick,1288,1222,66,-66,150700,151200,22760,-51360,-71160,OK
235.030372,TraderOne,Tick,1288,1232,56,-56,150800,151200,22609,-57209,-74009,OK
235.261317,TraderOne,Tick,1288,1242,46,-46,150900,151500,22458,-66058,-79858,OK
235.549808,TraderOne,Tick,1289,1242,47,-47,151100,151500,22488,-65688,-79788,OK
235.70423,TraderOne,Tick,1289,1242,47,-47,151100,151600,22488,-65688,-79788,OK
235.97713,TraderOne,Tick,1299,1242,57,-57,151200,151600,22790,-61990,-79090,OK
236.281815,TraderOne,Tick,1299,1242,57,-57,151200,151600,22790,-61990,-79090,OK
236.460948,TraderOne,Tick,1299,1242,57,-57,151000,151600,22790,-61990,-79090,OK
236.790125,TraderOne,Tick,1299,1245,54,-54,151200,151600,22745,-63445,-79645,OK
237.037259,TraderOne,Tick,1309,1245,64,-64,151000,151600,22594,-58294,-77494,OK
237.204579,TraderOne,Tick,1309,1245,64,-64,151000,151600,22594,-58294,-77494,OK
237.505417,TraderOne,Tick,1309,1245,64,-64,151000,151700,22594,-58294,-77494,OK
237.711812,TraderOne,Tick,1309,1245,64,-64,151000,151700,22594,-58294,-77494,OK
238.019937,TraderOne,Tick,1309,1245,64,-64,151000,151700,22594,-58294,-77494,OK
238.237506,TraderOne,Tick,1309,1245,64,-64,151000,151700,22594,-58294,-77494,OK
238.48104,TraderOne,Tick,1309,1255,54,-54,151000,151700,22896,-64596,-80796,OK
238.70515,TraderOne,Tick,1309,1255,54,-54,151000,151700,22896,-64596,-80796,OK
239.001144,TraderOne,Tick,1309,1255,54,-54,151000,151700,22896,-64596,-80796,OK
239.244068,TraderOne,Tick,1309,1255,54,-54,151000,151500,22896,-64596,-80796,OK
239.496969,TraderOne,Tick,1309,1265,44,-54,151300,151500,22745,1446555,-77245,OK
239.787583,TraderOne,Tick,1309,1265,44,-44,151300,151500,22745,-69445,-78245,OK
240.017058,TraderOne,Tick,1309,1265,44,-44,151300,151500,22745,-69445,-78245,OK
240.286551,TraderOne,Tick,1309,1265,44,-44,151300,151400,22745,-69445,-73845,OK
240.469453,TraderOne,Tick,1309,1275,34,-34,151400,151400,22594,-73294,-73294,OK
240.759492,TraderOne,Tick,1309,1275,34,-34,151400,151500,22594,-73294,-76694,OK
241.023713,TraderOne,Tick,1309,1275,34,-34,151400,151500,22594,-73294,-76694,OK
241.282476,TraderOne,Tick,1309,1275,34,-34,151400,151500,22594,-73294,-76694,OK
241.520014,TraderOne,Tick,1309,1275,34,-34,151400,151500,22594,-73294,-76694,OK
241.773393,TraderOne,Tick,1309,1275,34,-34,151400,151500,22594,-73294,-76694,OK
241.971499,TraderOne,Tick,1329,1275,54,-54,150900,151500,22292,-67992,-84192,OK
242.294898,TraderOne,Tick,1339,1275,64,-64,150800,151300,22141,-64841,-84041,OK
242.544145,TraderOne,Tick,1339,1285,54,-54,150800,151300,22443,-70143,-86343,OK
242.747927,TraderOne,Tick,1339,1295,44,-44,150800,151300,22745,-75445,-88645,OK
242.99244,TraderOne,Tick,1339,1295,44,-44,150800,151300,22745,-75445,-88645,OK
243.245906,TraderOne,Tick,1339,1295,44,-44,150800,151300,22745,-75445,-88645,OK
243.482614,TraderOne,Tick,1342,1295,47,-47,150800,151300,22700,-73900,-88000,OK
243.77752,TraderOne,Tick,1342,1295,47,-47,150800,151300,22700,-73900,-88000,OK
244.044871,TraderOne,Tick,1342,1295,47,-47,150800,151500,22700,-73900,-88000,OK
244.268746,TraderOne,Tick,1342,1295,47,-47,150800,151500,22700,-73900,-88000,OK
244.519612,TraderOne,Tick,1342,1295,47,-47,150800,151500,22700,-73900,-88000,OK
244.704009,TraderOne,Tick,1342,1295,47,-47,150800,151500,22700,-73900,-88000,OK
244.973738,TraderOne,Tick,1342,1295,47,-47,150800,151500,22700,-73900,-88000,OK
245.222965,TraderOne,Tick,1342,1295,47,-47,150800,151400,22700,-73900,-88000,OK
245.548022,TraderOne,Tick,1342,1305,37,-37,151400,151800,22549,-81749,-92849,OK
245.715337,TraderOne,Tick,1352,1305,47,-47,151400,151800,22852,-79052,-93152,OK
245.953682,TraderOne,Tick,1352,1305,47,-47,151400,151800,22852,-79052,-93152,OK
246.258152,TraderOne,Tick,1352,1305,47,-47,151400,151800,22852,-79052,-93152,OK
246.505404,TraderOne,Tick,1352,1305,47,-47,151400,151800,22852,-79052,-93152,OK
246.7171,TraderOne,Tick,1352,1305,47,-47,151400,151800,22852,-79052,-93152,OK
247.046333,TraderOne,Tick,1352,1305,47,-47,151400,152100,22852,-79052,-93152,OK
247.25189,TraderOne,Tick,1362,1305,57,-57,151700,152100,23155,-73655,-90755,OK
247.498063,TraderOne,Tick,1362,1305,57,-57,151700,152100,23155,-73655,-90755,OK
247.764165,TraderOne,Tick,1362,1305,57,-57,151400,152100,23155,-73655,-90755,OK
248.034786,TraderOne,Tick,1362,1305,57,-57,151400,152100,23155,-73655,-90755,OK
248.263391,TraderOne,Tick,1362,1305,57,-57,151500,152100,23155,-73655,-90755,OK
248.458826,TraderOne,Tick,1362,1305,57,-57,151500,152100,23155,-73655,-90755,OK
248.730121,TraderOne,Tick,1362,1305,57,-57,151500,152100,23155,-73655,-90755,OK
249.023228,TraderOne,Tick,1362,1305,57,-57,151800,152300,23155,-73655,-90755,OK
249.20193,TraderOne,Tick,1372,1305,67,-67,151800,152500,23459,-68959,-89059,OK
249.458527,TraderOne,Tick,1372,1315,57,-57,152000,152900,23307,-75807,-92907,OK
249.748784,TraderOne,Tick,1382,1315,67,-67,152400,152700,23611,-68111,-88211,OK
249.990897,TraderOne,Tick,1382,1325,57,-57,152400,152700,23916,-71416,-88516,OK
250.213461,TraderOne,Tick,1382,1325,57,-57,152400,152700,23916,-71416,-88516,OK
250.520268,TraderOne,Tick,1382,1335,47,-47,152600,152700,23764,-76264,-80964,OK
250.725724,TraderOne,Tick,1382,1335,47,-47,152600,152700,23764,-76264,-80964,OK
251.000459,TraderOne,Tick,1382,1335,47,-47,152600,152700,23764,-76264,-80964,OK
251.263851,TraderOne,Tick,1382,1335,47,-47,152000,152500,23764,-76264,-90364,OK
251.473678,TraderOne,Tick,1382,1335,47,-47,152000,152600,23764,-76264,-90364,OK
251.791254,TraderOne,Tick,1382,1335,47,-47,152000,152500,23764,-76264,-90364,OK
251.981462,TraderOne,Tick,1382,1335,47,-47,152000,152500,23764,-76264,-90364,OK
252.274543,TraderOne,Tick,1382,1335,47,-47,152000,152500,23764,-76264,-90364,OK
252.543996,TraderOne,Tick,1382,1335,47,-47,152000,152500,23764,-76264,-90364,OK
252.729455,TraderOne,Tick,1382,1345,37,-37,152600,152500,23612,-80112,-76412,OK
253.046328,TraderOne,Tick,1382,1345,37,-37,152600,152500,23612,-80112,-76412,OK
253.243993,TraderOne,Tick,1382,1345,37,-37,152600,152500,23612,-80112,-76412,OK
253.491516,TraderOne,Tick,1382,1345,37,-37,152600,152500,23612,-80112,-76412,OK
253.702528,TraderOne,Tick,1382,1345,37,-37,152600,152500,23612,-80112,-76412,OK
253.985944,TraderOne,Tick,1382,1345,37,-37,152600,152500,23612,-80112,-76412,OK
254.265642,TraderOne,Tick,1382,1345,37,-37,152600,152500,23612,-80112,-76412,OK
254.463854,TraderOne,Tick,1382,1355,27,-27,152200,152500,23460,-82960,-91060,OK
254.722738,TraderOne,Tick,1382,1355,27,-27,152200,152500,23460,-82960,-91060,OK
254.97956,TraderOne,Tick,1382,1355,27,-27,152200,152500,23460,-82960,-91060,OK
255.297649,TraderOne,Tick,1382,1355,27,-27,152200,152500,23460,-82960,-91060,OK
255.505459,TraderOne,Tick,1382,1355,27,-27,152200,152500,23460,-82960,-91060,OK
255.716805,TraderOne,Tick,1382,1355,27,-27,152200,152500,23460,-82960,-91060,OK
255.987495,TraderOne,Tick,1382,1355,27,-27,152200,152200,23460,-82960,-82960,OK
256.269095,TraderOne,Tick,1382,1355,27,-27,152200,152000,23460,-82960,-77560,OK
256.531503,TraderOne,Tick,1382,1355,27,-27,152200,152000,23460,-82960,-77560,OK
256.736036,TraderOne,Tick,1382,1355,27,-27,152200,152000,23460,-82960,-77560,OK
257.050061,TraderOne,Tick,1382,1355,27,-27,152200,152000,23460,-82960,-77560,OK
257.256552,TraderOne,Tick,1392,1355,37,-37,151400,152000,23308,-80808,-91908,OK
257.486915,TraderOne,Tick,1392,1355,37,-37,151400,152000,23308,-80808,-91908,OK
257.754539,TraderOne,Tick,1402,1355,47,-47,151700,152000,23611,-78111,-92211,OK
257.959947,TraderOne,Tick,1402,1355,47,-47,151700,152000,23611,-78111,-92211,OK
258.297468,TraderOne,Tick,1402,1365,37,-37,151700,151900,23459,-80959,-88359,OK
258.53214,TraderOne,Tick,1402,1365,37,-37,151700,151800,23459,-80959,-84659,OK
258.78722,TraderOne,Tick,1402,1365,37,-37,151700,151700,23459,-80959,-80959,OK
258.969317,TraderOne,Tick,1402,1375,27,-27,151700,151700,23307,-83807,-83807,OK
259.283616,TraderOne,Tick,1402,1375,27,-27,151700,151600,23307,-83807,-81107,OK
259.475403,TraderOne,Tick,1402,1375,27,-27,151700,151600,23307,-83807,-81107,OK
259.784895,TraderOne,Tick,1402,1375,27,-27,151700,151600,23307,-83807,-81107,OK
260.026269,TraderOne,Tick,1402,1375,27,-27,151700,151600,23307,-83807,-81107,OK
260.219454,TraderOne,Tick,1412,1375,37,-37,151300,151600,23156,-81656,-92756,OK
260.470868,TraderOne,Tick,1412,1375,37,-37,151300,151600,23156,-81656,-92756,OK
260.742042,TraderOne,Tick,1412,1385,27,-27,151300,151800,23459,-84959,-93059,OK
261.000119,TraderOne,Tick,1412,1385,27,-27,151300,151800,23459,-84959,-93059,OK
261.230858,TraderOne,Tick,1412,1385,27,-27,151300,151800,23459,-84959,-93059,OK
261.484205,TraderOne,Tick,1412,1385,27,-27,151300,151800,23459,-84959,-93059,OK
261.769034,TraderOne,Tick,1412,1395,17,-17,152000,151800,23307,-86807,-83407,OK
262.033812,TraderOne,Tick,1422,1395,27,-27,151600,151800,23155,-86655,-92055,OK
262.270046,TraderOne,Tick,1432,1395,37,-37,151600,151800,23458,-84958,-92358,OK
262.457339,TraderOne,Tick,1432,1395,37,-37,151600,151800,23458,-84958,-92358,OK
262.762466,TraderOne,Tick,1432,1395,37,-37,151600,151800,23458,-84958,-92358,OK
262.957028,TraderOne,Tick,1432,1395,37,-37,151600,151800,23458,-84958,-92358,OK
263.282958,TraderOne,Tick,1442,1395,47,-47,151600,152200,23761,-81261,-95361,OK
263.542505,TraderOne,Tick,1451,1395,56,-56,151600,152200,24034,-77934,-94734,OK
263.783069,TraderOne,Tick,1451,1405,46,-46,151500,152200,24337,-83237,-97037,OK
263.973761,TraderOne,Tick,1451,1405,46,-46,151500,152200,24337,-83237,-97037,OK
264.296756,TraderOne,Tick,1451,1405,46,-46,151500,152200,24337,-83237,-97037,OK
264.519966,TraderOne,Tick,1451,1405,46,-46,151500,152200,24337,-83237,-97037,OK
264.7055,TraderOne,Tick,1451,1405,46,-46,151500,151800,24337,-83237,-97037,OK
265.018346,TraderOne,Tick,1451,1405,46,-46,151500,151800,24337,-83237,-97037,OK
265.256759,TraderOne,Tick,1451,1405,46,-46,151500,151800,24337,-83237,-97037,OK
265.491964,TraderOne,Tick,1451,1405,46,-46,151500,151800,24337,-83237,-97037,OK
265.715573,TraderOne,Tick,1451,1405,46,-46,151500,151800,24337,-83237,-97037,OK
266.02592,TraderOne,Tick,1451,1415,36,-36,152100,151800,24185,-89085,-78285,OK
266.288232,TraderOne,Tick,1451,1415,36,-36,152100,151800,24185,-89085,-78285,OK
266.488749,TraderOne,Tick,1451,1421,30,-30,151800,151800,24094,-90794,-90794,OK
266.735414,TraderOne,Tick,1451,1421,30,-30,151800,151800,24094,-90794,-90794,OK
266.960403,TraderOne,Tick,1451,1421,30,-30,151800,152200,24094,-90794,-99794,OK
267.258858,TraderOne,Tick,1451,1421,30,-30,151800,152200,24094,-90794,-99794,OK
267.475668,TraderOne,Tick,1451,1431,20,-20,152100,152200,23942,-93642,-95642,OK
267.723004,TraderOne,Tick,1451,1431,20,-20,152100,152200,23942,-93642,-95642,OK
267.990155,TraderOne,Tick,1451,1431,20,-20,152100,152200,23942,-93642,-95642,OK
268.296862,TraderOne,Tick,1461,1431,30,-30,152200,152200,24246,-90946,-90946,OK
268.549746,TraderOne,Tick,1464,1431,33,-33,152200,152200,24337,-90137,-90137,OK
268.705256,TraderOne,Tick,1464,1431,33,-33,152200,152600,24337,-90137,-100037,OK
269.036483,TraderOne,Tick,1464,1431,33,-33,152200,152600,24337,-90137,-100037,OK
269.204964,TraderOne,Tick,1464,1431,33,-33,152200,152600,24337,-90137,-100037,OK
269.454125,TraderOne,Tick,1464,1431,33,-33,152200,153000,24337,-90137,-100037,OK
269.784396,TraderOne,Tick,1474,1431,43,-43,152300,153000,24642,-86442,-99342,OK
270.004525,TraderOne,Tick,1484,1431,53,-53,152100,153000,24718,-82518,-98418,OK
270.216738,TraderOne,Tick,1484,1431,53,-53,152100,153000,24718,-82518,-98418,OK
270.5255,TraderOne,Tick,1484,1431,53,-53,152100,152900,24718,-82518,-98418,OK
270.753625,TraderOne,Tick,1484,1431,53,-53,152100,152900,24718,-82518,-98418,OK
270.998791,TraderOne,Tick,1484,1431,53,-53,152100,153000,24718,-82518,-98418,OK
271.253985,TraderOne,Tick,1484,1431,53,-53,152100,153000,24718,-82518,-98418,OK
271.501983,TraderOne,Tick,1494,1441,53,-53,152700,153300,24870,-82670,-98570,OK
271.738333,TraderOne,Tick,1504,1441,63,-63,152800,153700,25176,-76976,-95876,OK
272.012685,TraderOne,Tick,1504,1461,43,-43,153100,153600,24870,-90670,-103570,OK
272.298393,TraderOne,Tick,1514,1461,53,-53,153300,153600,25177,-86977,-102877,OK
272.522133,TraderOne,Tick,1514,1471,43,-43,153600,153600,25024,-90824,-90824,OK
272.727883,TraderOne,Tick,1524,1471,53,-53,152800,153600,24871,-87671,-103571,OK
273.003932,TraderOne,Tick,1524,1471,53,-53,152800,153600,24871,-87671,-103571,OK
273.203366,TraderOne,Tick,1524,1471,53,-53,152800,153600,24871,-87671,-103571,OK
273.478495,TraderOne,Tick,1534,1471,63,-63,152600,153600,24718,-82518,-101418,OK
273.772128,TraderOne,Tick,1534,1481,53,-53,152700,153600,24565,-88365,-104265,OK
274.017471,TraderOne,Tick,1534,1491,43,-43,153800,153600,24412,-92212,-83612,OK
274.291764,TraderOne,Tick,1534,1491,43,-43,153800,153600,24412,-92212,-83612,OK
274.493805,TraderOne,Tick,1534,1491,43,-43,153800,152900,24412,-92212,-79312,OK
274.768317,TraderOne,Tick,1534,1501,33,-33,152500,152900,24717,-96517,-106417,OK
274.982031,TraderOne,Tick,1534,1501,33,-33,152500,152900,24717,-96517,-106417,OK
275.202767,TraderOne,Tick,1544,1511,33,-33,152300,152700,24870,-96670,-106570,OK
275.509479,TraderOne,Tick,1544,1520,24,-24,152400,152700,24733,-101933,-109133,OK
275.750367,TraderOne,Tick,1544,1520,24,-24,152400,152700,24733,-101933,-109133,OK
276.006628,TraderOne,Tick,1544,1520,24,-24,152400,152700,24733,-101933,-109133,OK
276.27607,TraderOne,Tick,1544,1520,24,-24,152400,153000,24733,-101933,-109133,OK
276.486431,TraderOne,Tick,1544,1520,24,-24,152400,153100,24733,-101933,-109133,OK
276.727701,TraderOne,Tick,1544,1520,24,-24,152400,153100,24733,-101933,-109133,OK
276.969168,TraderOne,Tick,1554,1520,34,-34,152400,153100,24580,-100780,-110980,OK
277.253521,TraderOne,Tick,1554,1520,34,-34,152400,153100,24580,-100780,-110980,OK
277.532008,TraderOne,Tick,1554,1520,34,-34,152400,152900,24580,-100780,-110980,OK
277.732536,TraderOne,Tick,1554,1520,34,-34,152400,152900,24580,-100780,-110980,OK
278.026903,TraderOne,Tick,1554,1520,34,-34,152400,152900,24580,-100780,-110980,OK
278.244777,TraderOne,Tick,1554,1520,34,-34,152400,152900,24580,-100780,-110980,OK
278.45832,TraderOne,Tick,1554,1520,34,-34,152400,153000,24580,-100780,-110980,OK
278.712816,TraderOne,Tick,1554,1530,24,-24,152800,153200,24427,-106627,-113827,OK
278.978598,TraderOne,Tick,1554,1530,24,-24,152800,153200,24427,-106627,-113827,OK
279.237869,TraderOne,Tick,1554,1530,24,-24,152800,153200,24427,-106627,-113827,OK
279.477568,TraderOne,Tick,1554,1530,24,-24,152800,153200,24427,-106627,-113827,OK
279.74739,TraderOne,Tick,1554,1530,24,-24,152800,153200,24427,-106627,-113827,OK
279.984057,TraderOne,Tick,1554,1530,24,-24,152800,153200,24427,-106627,-113827,OK
280.245562,TraderOne,Tick,1554,1530,24,-24,152800,153000,24427,-106627,-111427,OK
280.543189,TraderOne,Tick,1554,1540,14,-14,152800,152800,24733,-108933,-108933,OK
280.715958,TraderOne,Tick,1554,1550,4,-4,152800,152800,25039,-109239,-109239,OK
281.021045,TraderOne,Tick,1554,1550,4,-4,152800,152600,25039,-109239,-108439,OK
281.294375,TraderOne,Tick,1554,1560,-6,6,152800,152700,25345,-108545,-109145,OK
281.497519,TraderOne,Tick,1554,1560,-6,6,152800,152700,25345,-108545,-109145,OK
281.765635,TraderOne,Tick,1554,1560,-6,6,152800,152700,25345,-108545,-109145,OK
281.998848,TraderOne,Tick,1554,1560,-6,6,152800,152700,25345,-108545,-109145,OK
282.292647,TraderOne,Tick,1564,1560,4,-4,152300,152700,25192,-109392,-110592,OK
282.534099,TraderOne,Tick,1564,1560,4,-4,152300,152700,25192,-109392,-110592,OK
282.718098,TraderOne,Tick,1564,1560,4,-4,152300,152800,25192,-109392,-110592,OK
283.02138,TraderOne,Tick,1564,1560,4,-4,152300,152800,25192,-109392,-110592,OK
283.246119,TraderOne,Tick,1564,1560,4,-4,152300,152800,25192,-109392,-110592,OK
283.494973,TraderOne,Tick,1564,1560,4,-4,152300,152800,25192,-109392,-110592,OK
283.709107,TraderOne,Tick,1564,1560,4,-4,152300,152800,25192,-109392,-110592,OK
284.009503,TraderOne,Tick,1574,1560,14,-14,152300,152800,25039,-109239,-113439,OK
284.276548,TraderOne,Tick,1574,1570,4,-4,153400,152800,24886,-110086,-108886,OK
284.513534,TraderOne,Tick,1574,1570,4,-4,153400,152800,24886,-110086,-108886,OK
284.778372,TraderOne,Tick,1584,1570,14,-14,152400,152800,24733,-109933,-114133,OK
285.003569,TraderOne,Tick,1584,1570,14,-14,152400,153100,24733,-109933,-114133,OK
285.237238,TraderOne,Tick,1593,1570,23,-23,153000,153500,24595,-106195,-113095,OK
285.547038,TraderOne,Tick,1593,1580,13,-13,153900,153500,24442,-108042,-104142,OK
285.719044,TraderOne,Tick,1593,1580,13,-13,153900,153500,24442,-108042,-104142,OK
286.042546,TraderOne,Tick,1593,1580,13,-13,153900,153800,24442,-108042,-106742,OK
286.24384,TraderOne,Tick,1593,1580,13,-13,153900,153600,24442,-108042,-104142,OK
286.533705,TraderOne,Tick,1593,1580,13,-13,153900,153600,24442,-108042,-104142,OK
286.736248,TraderOne,Tick,1593,1580,13,-13,153900,153600,24442,-108042,-104142,OK
286.993573,TraderOne,Tick,1593,1590,3,-3,153900,153600,24289,-108889,-107989,OK
287.299862,TraderOne,Tick,1593,1590,3,-3,153900,153500,24289,-108889,-107989,OK
287.488407,TraderOne,Tick,1598,1590,8,-8,153500,153500,24212,-108812,-108812,OK
287.714415,TraderOne,Tick,1598,1590,8,-8,153500,153600,24212,-108812,-109612,OK
287.990456,TraderOne,Tick,1598,1590,8,-8,153500,153600,24212,-108812,-109612,OK
288.216229,TraderOne,Tick,1598,1590,8,-8,153500,153600,24212,-108812,-109612,OK
288.543326,TraderOne,Tick,1598,1590,8,-8,153500,153400,24212,-108812,-108012,OK
288.78918,TraderOne,Tick,1598,1590,8,-8,153500,153400,24212,-108812,-108012,OK
288.964955,TraderOne,Tick,1598,1590,8,-8,153500,153400,24212,-108812,-108012,OK
289.252228,TraderOne,Tick,1598,1590,8,-8,153500,153400,24212,-108812,-108012,OK
289.50503,TraderOne,Tick,1598,1590,8,-8,153500,153400,24212,-108812,-108012,OK
289.757245,TraderOne,Tick,1598,1590,8,-8,153500,153400,24212,-108812,-108012,OK
290.044636,TraderOne,Tick,1598,1590,8,-8,153500,153400,24212,-108812,-108012,OK
290.293079,TraderOne,Tick,1598,1590,8,-8,153400,153500,24212,-108812,-109612,OK
290.520442,TraderOne,Tick,1598,1590,8,-8,153400,153500,24212,-108812,-109612,OK
290.715489,TraderOne,Tick,1598,1590,8,-8,153400,153500,24212,-108812,-109612,OK
290.999527,TraderOne,Tick,1606,1600,6,-6,153400,153500,23935,-108535,-109135,OK
291.294335,TraderOne,Tick,1606,1600,6,-6,153400,153500,23935,-108535,-109135,OK
291.550113,TraderOne,Tick,1606,1610,-4,4,153900,153500,23781,-108381,-109581,OK
291.772652,TraderOne,Tick,1606,1610,-4,4,153900,153500,23781,-108381,-109581,OK
291.975892,TraderOne,Tick,1606,1610,-4,4,153900,153500,23781,-108381,-109581,OK
292.243729,TraderOne,Tick,1606,1610,-4,4,153900,153500,23781,-108381,-109581,OK
292.474872,TraderOne,Tick,1606,1620,-14,14,153900,153500,23627,-106227,-110427,OK
292.741718,TraderOne,Tick,1606,1630,-24,24,153900,153600,23935,-103535,-110735,OK
293.009493,TraderOne,Tick,1606,1630,-24,24,153900,153600,23935,-103535,-110735,OK
293.262483,TraderOne,Tick,1606,1630,-24,24,153900,153600,23935,-103535,-110735,OK
293.463496,TraderOne,Tick,1606,1640,-34,34,153900,153400,24243,-100843,-111043,OK
293.705028,TraderOne,Tick,1606,1640,-34,34,153900,153400,24243,-100843,-111043,OK
294.021698,TraderOne,Tick,1606,1650,-44,44,153900,153400,24551,-97151,-110351,OK
294.226175,TraderOne,Tick,1606,1650,-44,44,153900,153400,24551,-97151,-110351,OK
294.541037,TraderOne,Tick,1606,1650,-44,44,153900,153400,24551,-97151,-110351,OK
294.773733,TraderOne,Tick,1606,1650,-44,44,154000,153400,24551,-97151,-110351,OK
294.972052,TraderOne,Tick,1606,1650,-44,44,154000,153500,24551,-97151,-110351,OK
295.293327,TraderOne,Tick,1616,1650,-34,34,154000,153500,24859,-102459,-112659,OK
295.519281,TraderOne,Tick,1626,1650,-24,24,153800,153500,24705,-106305,-113505,OK
295.790172,TraderOne,Tick,1626,1650,-24,24,153800,153500,24705,-106305,-113505,OK
295.956008,TraderOne,Tick,1626,1650,-24,24,153800,153500,24705,-106305,-113505,OK
296.228112,TraderOne,Tick,1626,1650,-24,24,153800,153500,24705,-106305,-113505,OK
296.504118,TraderOne,Tick,1626,1650,-24,24,153800,153500,24705,-106305,-113505,OK
296.728639,TraderOne,Tick,1626,1660,-34,34,153800,153400,25013,-103613,-113813,OK
296.973085,TraderOne,Tick,1626,1660,-34,34,153800,153400,25013,-103613,-113813,OK
297.232453,TraderOne,Tick,1626,1660,-34,34,153800,153200,25013,-103613,-113813,OK
297.533152,TraderOne,Tick,1626,1670,-44,44,153700,153300,25320,-99920,-113120,OK
297.710413,TraderOne,Tick,1626,1670,-44,44,153700,153300,25320,-99920,-113120,OK
298.029261,TraderOne,Tick,1636,1670,-34,34,153800,153500,25628,-104228,-114428,OK
298.269646,TraderOne,Tick,1646,1670,-24,24,153100,153600,25474,-107074,-99874,OK
298.484167,TraderOne,Tick,1656,1670,-14,14,153100,153600,25780,-102380,-98180,OK
298.768819,TraderOne,Tick,1666,1670,-4,4,153100,153600,26086,-97686,-96486,OK
298.972541,TraderOne,Tick,1676,1670,6,-6,153100,153600,26392,-93992,-95792,OK
299.287913,TraderOne,Tick,1676,1670,6,-6,153100,153400,26392,-93992,-95792,OK
299.461912,TraderOne,Tick,1676,1670,6,-6,153100,153400,26392,-93992,-95792,OK
299.765892,TraderOne,Tick,1676,1670,6,-6,153100,153500,26392,-93992,-95792,OK
300.039518,TraderOne,Tick,1676,1670,6,-6,153100,153700,26392,-93992,-95792,OK
300.20556,TraderOne,Tick,1676,1670,6,-6,153100,153700,26392,-93992,-95792,OK
300.490874,TraderOne,Tick,1676,1670,6,-6,153100,153600,26392,-93992,-95792,OK
300.731339,TraderOne,Tick,1676,1670,6,-6,153100,153600,26392,-93992,-95792,OK
300.997367,TraderOne,Tick,1676,1670,6,-6,153100,153600,26392,-93992,-95792,OK
301.213828,TraderOne,Tick,1676,1670,6,-6,153100,153700,26392,-93992,-95792,OK
301.529028,TraderOne,Tick,1676,1670,6,-6,153100,153600,26392,-93992,-95792,OK
301.71454,TraderOne,Tick,1676,1670,6,-6,153100,153600,26392,-93992,-95792,OK
301.97516,TraderOne,Tick,1676,1670,6,-6,153100,153600,26392,-93992,-95792,OK
302.200913,TraderOne,Tick,1676,1670,6,-6,153100,153600,26392,-93992,-95792,OK
302.520608,TraderOne,Tick,1676,1670,6,-6,153100,153600,26392,-93992,-95792,OK
302.759107,TraderOne,Tick,1686,1670,16,-16,153300,153600,26238,-94838,-99638,OK
302.987404,TraderOne,Tick,1686,1680,6,-6,153700,153600,26545,-95145,-94545,OK
303.261149,TraderOne,Tick,1696,1690,6,-6,153000,153300,26698,-95298,-97098,OK
303.475881,TraderOne,Tick,1696,1690,6,-6,153000,153300,26698,-95298,-97098,OK
303.748024,TraderOne,Tick,1696,1690,6,-6,153000,153400,26698,-95298,-97098,OK
304.01771,TraderOne,Tick,1696,1690,6,-6,153000,153400,26698,-95298,-97098,OK
304.270436,TraderOne,Tick,1696,1700,-4,4,154000,153200,26544,-93144,-94344,OK
304.491799,TraderOne,Tick,1696,1700,-4,4,154000,153000,26544,-93144,-94344,OK
304.711212,TraderOne,Tick,1696,1700,-4,4,154000,153100,26544,-93144,-94344,OK
304.954151,TraderOne,Tick,1706,1710,-4,4,153700,152900,26238,-90838,-92038,OK
305.23234,TraderOne,Tick,1716,1710,6,-6,152500,152900,26085,-90685,-92485,OK
305.467244,TraderOne,Tick,1716,1710,6,-6,152500,152900,26085,-90685,-92485,OK
305.725082,TraderOne,Tick,1716,1710,6,-6,152500,152800,26085,-90685,-92485,OK
305.989393,TraderOne,Tick,1716,1710,6,-6,152500,152800,26085,-90685,-92485,OK
306.248412,TraderOne,Tick,1716,1710,6,-6,152500,152800,26085,-90685,-92485,OK
306.461601,TraderOne,Tick,1726,1710,16,-16,152500,152600,25932,-91532,-93132,OK
306.718367,TraderOne,Tick,1726,1710,16,-16,152500,152600,25932,-91532,-93132,OK
306.962797,TraderOne,Tick,1726,1710,16,-16,152500,152600,25932,-91532,-93132,OK
307.252087,TraderOne,Tick,1726,1710,16,-16,152500,152900,25932,-91532,-96332,OK
307.535252,TraderOne,Tick,1726,1710,16,-16,152500,152900,25932,-91532,-96332,OK
307.799032,TraderOne,Tick,1726,1710,16,-16,152500,152900,25932,-91532,-96332,OK
308.012688,TraderOne,Tick,1726,1710,16,-16,152500,152900,25932,-91532,-96332,OK
308.274388,TraderOne,Tick,1726,1710,16,-16,152500,152900,25932,-91532,-96332,OK
308.519051,TraderOne,Tick,1726,1710,16,-16,152500,152900,25932,-91532,-96332,OK
308.76639,TraderOne,Tick,1726,1710,16,-16,152500,152900,25932,-91532,-96332,OK
308.991239,TraderOne,Tick,1726,1710,16,-16,152500,152900,25932,-91532,-96332,OK
309.217119,TraderOne,Tick,1726,1710,16,-16,152500,152900,25932,-91532,-96332,OK
309.542252,TraderOne,Tick,1736,1720,16,-16,152600,153200,25626,-90226,-95026,OK
309.73944,TraderOne,Tick,1736,1720,16,-16,152600,153200,25626,-90226,-95026,OK
309.965663,TraderOne,Tick,1736,1720,16,-16,152600,153400,25626,-90226,-95026,OK
310.289942,TraderOne,Tick,1736,1727,9,-9,153400,154100,25519,-92919,-95619,OK
310.482067,TraderOne,Tick,1746,1727,19,-19,153800,154200,25827,-91227,-96927,OK
310.720218,TraderOne,Tick,1756,1727,29,-29,153800,154200,26135,-89535,-98235,OK
310.958639,TraderOne,Tick,1766,1737,29,-29,154100,154200,26289,-88689,-91589,OK
311.24357,TraderOne,Tick,1766,1737,29,-29,154100,154200,26289,-88689,-91589,OK
311.488642,TraderOne,Tick,1766,1747,19,-19,154100,154200,26135,-90535,-92435,OK
311.711512,TraderOne,Tick,1766,1747,19,-19,154100,154200,26135,-90535,-92435,OK
311.962944,TraderOne,Tick,1766,1747,19,-19,154100,154200,26135,-90535,-92435,OK
312.287584,TraderOne,Tick,1766,1747,19,-19,154100,154200,26135,-90535,-92435,OK
312.459384,TraderOne,Tick,1766,1747,19,-19,154100,154200,26135,-90535,-92435,OK
312.785119,TraderOne,Tick,1776,1747,29,-29,153600,154200,26443,-89843,-98543,OK
312.964892,TraderOne,Tick,1776,1747,29,-29,153600,154200,26443,-89843,-98543,OK
